"","id","n_accidents","All.usual.residents","Males","Females","children","adults","A Road","B Road","Motorway","Not Classified","Unclassified","Total_km","LSOA11CD"
"1","W01000001",27,1115,546,569,138,977,6.159,0,0,18.098,32.424,56.681,"W01000001"
"2","W01000002",21,1263,625,638,245,1018,6.441,0,0,11.642,10.73,28.813,"W01000002"
"3","W01000003",24,2507,1235,1272,511,1996,0.499,0.463,0,5.514,11.334,17.81,"W01000003"
"4","W01000004",47,1282,623,659,242,1040,5.076,4.413,0,17.706,15.956,43.151,"W01000004"
"5","W01000005",60,1938,933,1005,303,1635,1.37,5.388,0,7.592,14.299,28.649,"W01000005"
"6","W01000006",45,1534,776,758,268,1266,2.324,10.703,0,23.001,26.356,62.384,"W01000006"
"7","W01000007",58,1704,823,881,301,1403,8.637,5.432,0,21.412,32.958,68.439,"W01000007"
"8","W01000008",34,1519,718,801,293,1226,1.951,0,0,1.345,5.07,8.366,"W01000008"
"9","W01000009",42,1903,924,979,405,1498,10.235,0.998,0,14.88,24.995,51.108,"W01000009"
"10","W01000010",27,1869,893,976,295,1574,0.774,4.977,0,8.777,12.33,26.858,"W01000010"
"11","W01000011",57,1230,595,635,159,1071,2.358,0.641,0,1.397,4.291,8.687,"W01000011"
"12","W01000012",45,1484,684,800,275,1209,0.774,0.7,0,4.337,8.853,14.664,"W01000012"
"13","W01000013",47,2254,1082,1172,427,1827,6.67,3.926,0,17.854,27.044,55.494,"W01000013"
"14","W01000014",34,2049,987,1062,449,1600,0,5.472,0,4.942,7.962,18.376,"W01000014"
"15","W01000015",64,1588,769,819,277,1311,3.525,0,0,1.946,6.69,12.161,"W01000015"
"16","W01000016",24,1203,627,576,265,938,0.623,0,0,1.066,2.693,4.382,"W01000016"
"17","W01000017",34,1525,754,771,360,1165,2.656,1.121,0,0.912,5.049,9.738,"W01000017"
"18","W01000018",39,1357,672,685,245,1112,5.602,0,0,10.326,14.357,30.285,"W01000018"
"19","W01000019",35,1513,742,771,209,1304,3.61,0.085,0,23.534,14.263,41.492,"W01000019"
"20","W01000020",63,1315,647,668,221,1094,0.125,12.197,0,40.883,40.185,93.39,"W01000020"
"21","W01000021",53,2264,1159,1105,386,1878,3.874,3.071,0,32.971,57.063,96.979,"W01000021"
"22","W01000022",44,1648,835,813,333,1315,9.34,0,0,29.391,41.721,80.452,"W01000022"
"23","W01000023",39,1406,697,709,280,1126,7.632,3.292,0,13.002,19.418,43.344,"W01000023"
"24","W01000024",24,1519,814,705,449,1070,0.072,0,0,17.154,11.994,29.22,"W01000024"
"25","W01000025",113,2016,1011,1005,388,1628,12.63,8.016,0,15.421,29.723,65.79,"W01000025"
"26","W01000026",3,1229,579,650,167,1062,0,0.683,0,9.052,19.912,29.647,"W01000026"
"27","W01000027",62,1851,920,931,362,1489,8.628,0.485,0,27.008,27.09,63.211,"W01000027"
"28","W01000028",38,1941,983,958,408,1533,0,11.332,0,31.492,55.901,98.725,"W01000028"
"29","W01000029",47,1493,717,776,341,1152,1.305,0,0,0.731,4.114,6.15,"W01000029"
"30","W01000030",5,2286,1097,1189,547,1739,0,0,0,1.524,6.419,7.943,"W01000030"
"31","W01000031",22,1545,775,770,279,1266,2.288,0,0,25.868,45.453,73.609,"W01000031"
"32","W01000032",23,1064,506,558,184,880,6.342,0,0,21.868,15.567,43.777,"W01000032"
"33","W01000033",14,1504,756,748,346,1158,0.129,0,0,2.576,4.274,6.979,"W01000033"
"34","W01000034",9,1154,566,588,224,930,0,0,0,1.733,7.801,9.534,"W01000034"
"35","W01000035",49,1869,914,955,359,1510,3.542,2.855,0,28.498,35.09,69.985,"W01000035"
"36","W01000036",7,1088,541,547,240,848,0.056,0,0,0.831,2.52,3.407,"W01000036"
"37","W01000037",8,1178,627,551,231,947,0,0,0,1.15,3.095,4.245,"W01000037"
"38","W01000038",35,2226,1072,1154,429,1797,5.98,8.242,0,43.479,23.286,80.987,"W01000038"
"39","W01000039",19,1060,528,532,159,901,0,2,0,26.225,13.129,41.354,"W01000039"
"40","W01000040",60,1168,543,625,163,1005,2.551,1.94,0,22.598,20.964,48.053,"W01000040"
"41","W01000041",3,1583,767,816,454,1129,0,1.079,0,3.077,3.583,7.739,"W01000041"
"42","W01000042",33,2146,1056,1090,456,1690,1.224,1.544,0,2.335,8.926,14.029,"W01000042"
"43","W01000043",42,1217,577,640,262,955,0.91,1.636,0,4.44,4.552,11.538,"W01000043"
"44","W01000044",20,1144,579,565,206,938,2.51,0.124,0,2.915,6.968,12.517,"W01000044"
"45","W01000045",10,NA,NA,NA,NA,NA,NA,NA,NA,NA,NA,NA,NA
"46","W01000046",63,NA,NA,NA,NA,NA,NA,NA,NA,NA,NA,NA,NA
"47","W01000047",86,1354,647,707,281,1073,7.372,3.371,0,33.828,17.891,62.462,"W01000047"
"48","W01000048",54,1380,650,730,275,1105,6.414,0,0,14.359,10.775,31.548,"W01000048"
"49","W01000049",51,1142,587,555,207,935,1.436,0,0,0.508,3.724,5.668,"W01000049"
"50","W01000050",176,1398,696,702,312,1086,16.042,0,0,25.308,39.13,80.48,"W01000050"
"51","W01000051",34,1974,952,1022,389,1585,2.053,0.955,0,2.472,9.266,14.746,"W01000051"
"52","W01000052",2,1171,574,597,271,900,0,1.016,0,2.788,3.985,7.789,"W01000052"
"53","W01000053",105,1219,622,597,277,942,3.657,3.897,0,21.017,23.219,51.79,"W01000053"
"54","W01000054",59,1162,571,591,232,930,1.39,0,0,9.303,16.566,27.259,"W01000054"
"55","W01000055",35,NA,NA,NA,NA,NA,NA,NA,NA,NA,NA,NA,NA
"56","W01000056",47,1878,956,922,415,1463,5.996,0,0,16.919,10.14,33.055,"W01000056"
"57","W01000057",137,1444,751,693,261,1183,27.365,3.035,0,199.979,86.904,317.283,"W01000057"
"58","W01000058",55,NA,NA,NA,NA,NA,NA,NA,NA,NA,NA,NA,NA
"59","W01000059",75,2060,1025,1035,460,1600,0.561,0.56,0,0.942,5.874,7.937,"W01000059"
"60","W01000060",123,1345,675,670,270,1075,24.601,0,0,169.414,53.299,247.314,"W01000060"
"61","W01000061",30,1753,823,930,310,1443,2.754,0.96,0,4.819,9.539,18.072,"W01000061"
"62","W01000062",56,1839,946,893,155,1684,0.558,0.056,0,1.382,3.912,5.908,"W01000062"
"63","W01000063",27,1909,931,978,484,1425,0.336,0,0,17,22.067,39.403,"W01000063"
"64","W01000064",48,1849,916,933,467,1382,1.876,0,0,3.17,4.062,9.108,"W01000064"
"65","W01000065",16,1126,542,584,208,918,0.712,0,0,3.791,4.9,9.403,"W01000065"
"66","W01000066",99,1219,611,608,241,978,12.894,1.197,0,32.905,46.837,93.833,"W01000066"
"67","W01000067",135,1204,606,598,176,1028,8.747,0.304,0,23.475,14.875,47.401,"W01000067"
"68","W01000068",25,1484,684,800,311,1173,0.002,0,0,2.332,8.675,11.009,"W01000068"
"69","W01000069",43,1540,742,798,216,1324,6.983,0,0,34.72,19.947,61.65,"W01000069"
"70","W01000070",67,1275,652,623,246,1029,7.689,13.889,0,32.804,56.071,110.453,"W01000070"
"71","W01000071",9,2380,1192,1188,586,1794,0.021,0.065,0,1.93,8.126,10.142,"W01000071"
"72","W01000072",34,1777,837,940,352,1425,0.776,0,0,0.699,6.235,7.71,"W01000072"
"73","W01000073",69,1695,840,855,349,1346,6.105,0,0,28.819,25.405,60.329,"W01000073"
"74","W01000074",66,1997,991,1006,315,1682,12.956,6.135,0,34.171,26.356,79.618,"W01000074"
"75","W01000075",48,1496,741,755,275,1221,0.508,0,0,0.689,4.287,5.484,"W01000075"
"76","W01000076",35,1316,677,639,149,1167,0.543,0,0,1.07,4.056,5.669,"W01000076"
"77","W01000077",32,1387,677,710,174,1213,0.703,0,0,0.689,3.043,4.435,"W01000077"
"78","W01000078",35,1683,840,843,362,1321,5.047,8.746,0,29.607,27.952,71.352,"W01000078"
"79","W01000079",27,1098,541,557,177,921,3.709,0,0,35.655,37.05,76.414,"W01000079"
"80","W01000080",62,1785,875,910,257,1528,7.319,1.748,0,31.736,18.342,59.145,"W01000080"
"81","W01000081",56,2026,998,1028,363,1663,7.943,0,0,13.564,15.86,37.367,"W01000081"
"82","W01000082",142,1095,554,541,233,862,19.635,21.749,0,70.983,39.385,151.752,"W01000082"
"83","W01000083",125,1293,668,625,251,1042,20.589,13.904,0,182.82,88.368,305.681,"W01000083"
"84","W01000084",25,1206,604,602,221,985,0,3.646,0,25.877,41.719,71.242,"W01000084"
"85","W01000085",62,2007,1030,977,295,1712,22.119,0,0,62.386,58.498,143.003,"W01000085"
"86","W01000086",66,2253,1105,1148,489,1764,12.03,5.43,0,45.404,59.944,122.808,"W01000086"
"87","W01000087",19,1916,925,991,482,1434,1.318,0,0,3.215,5.947,10.48,"W01000087"
"88","W01000088",59,1994,976,1018,449,1545,2.336,0,0,18.304,28.719,49.359,"W01000088"
"89","W01000089",61,2080,1013,1067,470,1610,8.46,8.678,0,57.769,70.237,145.144,"W01000089"
"90","W01000090",6,1426,651,775,416,1010,0,0,0,0.538,3.378,3.916,"W01000090"
"91","W01000091",14,1140,572,568,272,868,0.451,0,0,0.338,2.413,3.202,"W01000091"
"92","W01000092",58,4128,2021,2107,149,3979,2.213,0,0,2.58,5.663,10.456,"W01000092"
"93","W01000093",71,2196,1047,1149,337,1859,2.302,1.998,0,4.454,7.065,15.819,"W01000093"
"94","W01000094",9,1229,602,627,227,1002,0,6.11,0,10.368,13.103,29.581,"W01000094"
"95","W01000095",19,1373,670,703,304,1069,1.602,2.184,0,6.14,8.411,18.337,"W01000095"
"96","W01000096",8,1245,603,642,292,953,0.324,0,0,0.246,3.841,4.411,"W01000096"
"97","W01000097",41,1110,535,575,203,907,1.361,0,0,0.627,3.554,5.542,"W01000097"
"98","W01000098",15,2321,1129,1192,700,1621,0.148,0,0,4.978,4.535,9.661,"W01000098"
"99","W01000099",80,1768,885,883,403,1365,4.689,0.742,0,15.018,20.29,40.739,"W01000099"
"100","W01000100",8,1054,521,533,220,834,4.901,4.497,0,26.483,15.103,50.984,"W01000100"
"101","W01000101",65,1533,756,777,381,1152,4.164,0,0,13.289,8.802,26.255,"W01000101"
"102","W01000102",42,1217,610,607,254,963,1.102,0,0,3.988,6.758,11.848,"W01000102"
"103","W01000103",122,1233,597,636,266,967,6.9,0.121,0,19.067,21.127,47.215,"W01000103"
"104","W01000104",38,1793,839,954,377,1416,0.924,1.182,0,7.661,11.927,21.694,"W01000104"
"105","W01000105",14,1775,888,887,397,1378,1.856,0,0,5.071,6.152,13.079,"W01000105"
"106","W01000106",60,1732,844,888,208,1524,1.829,0,0,19.514,15.287,36.63,"W01000106"
"107","W01000107",60,1257,598,659,227,1030,30.454,0.416,0,57.581,18.854,107.305,"W01000107"
"108","W01000108",60,2190,1060,1130,463,1727,3.73,0,0,4.007,9.358,17.095,"W01000108"
"109","W01000109",6,1886,964,922,356,1530,0,0,0,3.345,8.543,11.888,"W01000109"
"110","W01000110",7,1506,711,795,346,1160,0.087,0,0,0.662,4.237,4.986,"W01000110"
"111","W01000111",57,1532,759,773,297,1235,1.174,0.488,0,4.749,8.966,15.377,"W01000111"
"112","W01000112",14,1930,951,979,463,1467,0,1.552,0,17.819,15.913,35.284,"W01000112"
"113","W01000113",63,1871,899,972,399,1472,8.302,7.027,0,18.569,12.459,46.357,"W01000113"
"114","W01000114",209,1604,795,809,328,1276,33.556,1.874,0,81.465,57.757,174.652,"W01000114"
"115","W01000115",64,2218,1088,1130,493,1725,2.095,5.126,0,17.018,19.843,44.082,"W01000115"
"116","W01000116",40,1685,777,908,219,1466,2.856,0,0,17.441,17.323,37.62,"W01000116"
"117","W01000117",25,1579,732,847,304,1275,0.839,0,0,4.48,8.021,13.34,"W01000117"
"118","W01000118",36,1676,823,853,382,1294,15.492,0.461,0,36.386,14.079,66.418,"W01000118"
"119","W01000119",42,2284,1145,1139,424,1860,1.05,0.271,0,8.434,19.377,29.132,"W01000119"
"120","W01000120",47,NA,NA,NA,NA,NA,NA,NA,NA,NA,NA,NA,NA
"121","W01000121",195,1244,637,607,218,1026,30.858,1.566,0,135.766,24.87,193.06,"W01000121"
"122","W01000122",153,2122,1047,1075,384,1738,12.635,17.949,0,41.635,116.972,189.191,"W01000122"
"123","W01000123",56,1815,913,902,356,1459,0.512,0,0,7.247,13.618,21.377,"W01000123"
"124","W01000124",52,2007,970,1037,350,1657,0,9.148,0,38.972,55.255,103.375,"W01000124"
"125","W01000125",103,1485,719,766,238,1247,3.034,0,0,7.221,9.846,20.101,"W01000125"
"126","W01000126",24,1716,879,837,352,1364,0.065,0,0,0.761,6.94,7.766,"W01000126"
"127","W01000127",30,1367,667,700,316,1051,0.609,0,0,0.358,2.722,3.689,"W01000127"
"128","W01000128",33,1483,709,774,283,1200,0.474,0,0,1.122,4.58,6.176,"W01000128"
"129","W01000129",39,1064,509,555,216,848,5.495,0,0,3.997,8.406,17.898,"W01000129"
"130","W01000130",49,1537,764,773,233,1304,1.312,0.065,0,1.455,5.412,8.244,"W01000130"
"131","W01000131",17,1464,696,768,330,1134,0,1.579,0,2.741,3.84,8.16,"W01000131"
"132","W01000132",52,1537,729,808,225,1312,0.005,0.329,0,0.724,3.226,4.284,"W01000132"
"133","W01000133",58,1887,870,1017,262,1625,0.271,1.07,0,3.987,9.898,15.226,"W01000133"
"134","W01000134",51,2118,1000,1118,413,1705,5.052,1.867,0,4.02,7.145,18.084,"W01000134"
"135","W01000135",55,2081,952,1129,265,1816,0.506,0.564,0,1.404,9.356,11.83,"W01000135"
"136","W01000136",37,1855,923,932,333,1522,0.653,0.408,0,1.561,6.49,9.112,"W01000136"
"137","W01000137",119,1537,767,770,296,1241,10.727,7.917,0,32.132,72.624,123.4,"W01000137"
"138","W01000138",19,1826,868,958,348,1478,0.094,1.495,0,0.998,4.101,6.688,"W01000138"
"139","W01000139",45,1721,864,857,417,1304,0.399,0.156,0,0.832,3.74,5.127,"W01000139"
"140","W01000140",145,1466,706,760,312,1154,5.321,0.236,0,9.057,14.374,28.988,"W01000140"
"141","W01000141",7,1542,703,839,171,1371,0.374,0,0,0.213,6.136,6.723,"W01000141"
"142","W01000142",13,1603,772,831,231,1372,0.974,0,0,2.587,6.174,9.735,"W01000142"
"143","W01000143",24,1543,785,758,362,1181,0,0,0,1.008,2.628,3.636,"W01000143"
"144","W01000144",77,1516,805,711,361,1155,3.346,0.598,0,1.262,4.105,9.311,"W01000144"
"145","W01000145",28,1281,603,678,282,999,0.307,0,0,0.46,3.299,4.066,"W01000145"
"146","W01000146",72,2254,1145,1109,303,1951,0.701,0,0,1.337,8.565,10.603,"W01000146"
"147","W01000147",29,1493,693,800,185,1308,0.484,0,0,4.071,13.292,17.847,"W01000147"
"148","W01000148",21,1205,563,642,295,910,0.818,0,0,2.371,3.748,6.937,"W01000148"
"149","W01000149",76,1490,720,770,256,1234,0.792,0,0,4.369,7.844,13.005,"W01000149"
"150","W01000150",34,1509,756,753,320,1189,0,0,0,0.456,8.061,8.517,"W01000150"
"151","W01000151",36,1589,765,824,437,1152,0.274,0,0,2.386,4.164,6.824,"W01000151"
"152","W01000152",40,1492,697,795,320,1172,0.528,0,0,3.136,4.631,8.295,"W01000152"
"153","W01000153",97,1542,766,776,268,1274,4.262,0,0,7.793,13.156,25.211,"W01000153"
"154","W01000154",21,1475,662,813,245,1230,0,0,0,0.735,5.244,5.979,"W01000154"
"155","W01000155",63,1549,678,871,238,1311,0,0.823,0,0.348,3.565,4.736,"W01000155"
"156","W01000156",34,1517,686,831,167,1350,0,0.002,0,0.302,4.319,4.623,"W01000156"
"157","W01000157",15,1465,692,773,283,1182,0,0,0,1.148,3.471,4.619,"W01000157"
"158","W01000158",69,1587,725,862,207,1380,0,1.223,0,1.393,5.584,8.2,"W01000158"
"159","W01000159",74,1435,721,714,274,1161,17.47,14.401,0,43.091,66.919,141.881,"W01000159"
"160","W01000160",22,NA,NA,NA,NA,NA,NA,NA,NA,NA,NA,NA,NA
"161","W01000161",176,NA,NA,NA,NA,NA,NA,NA,NA,NA,NA,NA,NA
"162","W01000162",52,1925,1015,910,420,1505,17.952,16.583,0,53.238,134.274,222.047,"W01000162"
"163","W01000163",41,1337,640,697,420,917,0.7,0,0,2.624,8.223,11.547,"W01000163"
"164","W01000164",9,1406,676,730,360,1046,0,0,0,1.799,6.839,8.638,"W01000164"
"165","W01000165",57,1930,959,971,333,1597,1.001,0.02,0,0.081,7.871,8.973,"W01000165"
"166","W01000166",76,1949,896,1053,438,1511,1.314,0.283,0,1.469,9.034,12.1,"W01000166"
"167","W01000167",48,1923,943,980,436,1487,1.809,0,0,1.298,7.92,11.027,"W01000167"
"168","W01000168",17,1784,825,959,414,1370,0.647,0,0,1.41,4.399,6.456,"W01000168"
"169","W01000169",109,1855,925,930,238,1617,0.212,0,0,0.914,7.073,8.199,"W01000169"
"170","W01000170",5,1822,890,932,351,1471,0,0,0,3.882,11.448,15.33,"W01000170"
"171","W01000171",16,1582,768,814,305,1277,0,0,0,2.616,8.897,11.513,"W01000171"
"172","W01000172",13,1286,610,676,288,998,2.266,0,0,1.949,7.164,11.379,"W01000172"
"173","W01000173",29,1549,807,742,389,1160,0.109,0.066,0,4.83,14.434,19.439,"W01000173"
"174","W01000174",25,1702,806,896,349,1353,0,0.364,0,0.094,4.095,4.553,"W01000174"
"175","W01000175",42,1632,765,867,221,1411,0,0.611,0,0.02,6.593,7.224,"W01000175"
"176","W01000176",63,1606,786,820,372,1234,1.724,0,0,1.414,4.669,7.807,"W01000176"
"177","W01000177",50,1237,596,641,263,974,0.511,0,0,2.189,6.162,8.862,"W01000177"
"178","W01000178",58,1901,882,1019,450,1451,1.762,0,0,0.872,4.394,7.028,"W01000178"
"179","W01000179",20,1604,741,863,195,1409,0.065,0,0,0.254,7.948,8.267,"W01000179"
"180","W01000180",22,1682,842,840,376,1306,0,1.761,0,2.951,6.604,11.316,"W01000180"
"181","W01000181",10,1556,766,790,390,1166,0,1.534,0,0.063,3.723,5.32,"W01000181"
"182","W01000182",69,1918,925,993,273,1645,1.572,0.867,0,0.743,4.475,7.657,"W01000182"
"183","W01000183",69,1485,751,734,321,1164,1.22,0.805,0,0.276,4.879,7.18,"W01000183"
"184","W01000184",90,2380,1120,1260,377,2003,2.14,0,0,19.941,12.977,35.058,"W01000184"
"185","W01000185",51,1229,619,610,214,1015,0,8.664,0,47.913,21.619,78.196,"W01000185"
"186","W01000186",94,1711,805,906,339,1372,1.657,0.561,0,0.914,4.972,8.104,"W01000186"
"187","W01000187",39,1561,715,846,509,1052,0.637,0,0,1.151,4.579,6.367,"W01000187"
"188","W01000188",19,1736,823,913,301,1435,0.352,0.172,0,0.31,4.782,5.616,"W01000188"
"189","W01000189",104,1465,764,701,245,1220,12.462,31.382,0,129.861,77.429,251.134,"W01000189"
"190","W01000190",93,1399,684,715,259,1140,13.272,19.454,0,134.809,85.035,252.57,"W01000190"
"191","W01000191",147,2147,1051,1096,491,1656,7.488,1.458,0,16.924,22.786,48.656,"W01000191"
"192","W01000192",82,1011,513,498,157,854,11.588,6.718,0,21.984,25.156,65.446,"W01000192"
"193","W01000193",99,1314,677,637,280,1034,8.22,1.236,0,8.865,16.648,34.969,"W01000193"
"194","W01000194",52,2122,1050,1072,443,1679,0.63,0.507,0,0.889,5.736,7.762,"W01000194"
"195","W01000195",22,1379,655,724,242,1137,1.548,0,0,0.302,4.826,6.676,"W01000195"
"196","W01000196",50,1506,744,762,356,1150,2.603,0,0,2.16,4.039,8.802,"W01000196"
"197","W01000197",47,1676,832,844,370,1306,2.788,0,0,7.624,6.896,17.308,"W01000197"
"198","W01000198",11,1475,760,715,398,1077,0,0.227,0,0.136,2.154,2.517,"W01000198"
"199","W01000199",70,1690,854,836,340,1350,3.015,7.714,0,11.975,8.929,31.633,"W01000199"
"200","W01000200",14,1283,628,655,275,1008,0.771,0,0,1.093,5.227,7.091,"W01000200"
"201","W01000201",72,1498,723,775,368,1130,1.584,2.179,0,2.429,8.744,14.936,"W01000201"
"202","W01000202",65,1686,826,860,416,1270,2.804,13.927,0,84.845,76.799,178.375,"W01000202"
"203","W01000203",209,2456,1242,1214,470,1986,21.756,13.108,0,70.176,54.372,159.412,"W01000203"
"204","W01000204",64,1421,720,701,227,1194,4.816,6.465,0,23.629,19.937,54.847,"W01000204"
"205","W01000205",21,1122,582,540,198,924,0,8.221,0,41.226,38.133,87.58,"W01000205"
"206","W01000206",90,2156,1074,1082,461,1695,3.789,6.747,0,21.181,55.206,86.923,"W01000206"
"207","W01000207",169,2227,1124,1103,410,1817,23.923,11.899,0,49.473,106.437,191.732,"W01000207"
"208","W01000208",110,1229,650,579,190,1039,10.94,1.015,0,22.35,38.965,73.27,"W01000208"
"209","W01000209",21,1496,731,765,284,1212,0.608,0,0,2.142,5.792,8.542,"W01000209"
"210","W01000210",50,1354,639,715,209,1145,3.742,0.021,0,6.66,11.769,22.192,"W01000210"
"211","W01000211",59,1856,930,926,355,1501,4.221,15.852,0,88.15,133.089,241.312,"W01000211"
"212","W01000212",50,2189,1052,1137,400,1789,0.6,0,0,0.001,7.525,8.126,"W01000212"
"213","W01000213",86,1343,628,715,336,1007,0.225,0.596,0,0.37,3.399,4.59,"W01000213"
"214","W01000214",35,1171,563,608,294,877,0.759,0,0,3.972,5.171,9.902,"W01000214"
"215","W01000215",15,1435,688,747,274,1161,0.267,0,0,0.207,4.176,4.65,"W01000215"
"216","W01000216",59,1409,677,732,326,1083,0.685,0,0,1.988,5.509,8.182,"W01000216"
"217","W01000217",40,2066,1010,1056,495,1571,1.188,0,0,0.708,6.755,8.651,"W01000217"
"218","W01000218",42,1546,737,809,309,1237,0.42,0.091,0,3,3.548,7.059,"W01000218"
"219","W01000219",32,2566,1237,1329,667,1899,0.522,0,0,1.488,6.874,8.884,"W01000219"
"220","W01000220",40,1604,772,832,116,1488,1.17,0,0,0.206,7.432,8.808,"W01000220"
"221","W01000221",16,1348,647,701,235,1113,0,0,0,0,3.732,3.732,"W01000221"
"222","W01000222",15,1660,771,889,245,1415,0,0,0,0.207,5.722,5.929,"W01000222"
"223","W01000223",167,1325,633,692,244,1081,2.945,0.221,0,5.015,8.324,16.505,"W01000223"
"224","W01000224",17,1402,672,730,276,1126,0.349,0,0,0.713,4.483,5.545,"W01000224"
"225","W01000225",99,1528,738,790,302,1226,1.075,0,0,2.607,4.782,8.464,"W01000225"
"226","W01000226",28,1515,753,762,252,1263,1.566,0.24,0,0.957,3.54,6.303,"W01000226"
"227","W01000227",40,1556,741,815,285,1271,0.621,0,0,0.315,4.117,5.053,"W01000227"
"228","W01000228",40,1146,576,570,203,943,0.572,0.737,0,1.033,3.305,5.647,"W01000228"
"229","W01000229",20,1606,767,839,256,1350,0.184,0,0,0,3.322,3.506,"W01000229"
"230","W01000230",50,1963,946,1017,319,1644,0.571,0,0,0.068,5.282,5.921,"W01000230"
"231","W01000231",21,1432,676,756,312,1120,0,0.327,0,0.06,3.043,3.43,"W01000231"
"232","W01000232",18,1605,777,828,345,1260,0,0.457,0,0.054,3.039,3.55,"W01000232"
"233","W01000233",21,1276,616,660,226,1050,0.163,0.116,0,0.001,2.493,2.773,"W01000233"
"234","W01000234",26,1405,665,740,377,1028,0,0.108,0,0.029,3.361,3.498,"W01000234"
"235","W01000235",10,1330,658,672,309,1021,0,0,0,0.074,3.541,3.615,"W01000235"
"236","W01000236",83,1875,897,978,534,1341,0.37,0,0,1.091,4.48,5.941,"W01000236"
"237","W01000237",41,1806,868,938,649,1157,0,0,0,0.832,5.143,5.975,"W01000237"
"238","W01000238",69,1702,826,876,441,1261,0.323,0.274,0,0.279,2.76,3.636,"W01000238"
"239","W01000239",69,1781,952,829,384,1397,0.284,0.69,0,1.677,3.232,5.883,"W01000239"
"240","W01000240",173,1316,755,561,265,1051,1.202,0.131,0,1.708,3.865,6.906,"W01000240"
"241","W01000241",58,1289,630,659,368,921,0.804,0.449,0,1.618,3.39,6.261,"W01000241"
"242","W01000242",28,1906,924,982,416,1490,2.404,0.664,0,1,5.775,9.843,"W01000242"
"243","W01000243",33,1823,892,931,407,1416,1.766,0,0,1.133,9.469,12.368,"W01000243"
"244","W01000244",8,1732,845,887,357,1375,1.475,0,0,0.183,6.148,7.806,"W01000244"
"245","W01000245",33,1674,826,848,318,1356,2.342,0,0,4.307,7.084,13.733,"W01000245"
"246","W01000246",74,1681,795,886,338,1343,1.953,2.161,0,1.67,7.16,12.944,"W01000246"
"247","W01000247",165,1970,953,1017,344,1626,5.533,5.46,0,25.291,28.125,64.409,"W01000247"
"248","W01000248",156,1649,819,830,332,1317,11.593,10.103,0,22.445,67.851,111.992,"W01000248"
"249","W01000249",4,1258,597,661,264,994,0,0,0,0.283,3.397,3.68,"W01000249"
"250","W01000250",47,1578,796,782,304,1274,3.576,0,0,1.652,5.03,10.258,"W01000250"
"251","W01000251",61,1486,716,770,353,1133,0.369,0.227,0,0,3.459,4.055,"W01000251"
"252","W01000252",88,1631,807,824,235,1396,1.269,0.311,0,1.222,6.964,9.766,"W01000252"
"253","W01000253",34,1941,964,977,435,1506,0.893,0,0,0.579,8.943,10.415,"W01000253"
"254","W01000254",69,2224,1094,1130,547,1677,3.269,0,0,2.095,11.792,17.156,"W01000254"
"255","W01000255",196,2292,1137,1155,482,1810,4.234,0.682,0,20.194,13.553,38.663,"W01000255"
"256","W01000256",39,1561,763,798,381,1180,3.076,0,0,1.713,4.993,9.782,"W01000256"
"257","W01000257",19,2121,1091,1030,401,1720,0.186,0,0,0.261,6.146,6.593,"W01000257"
"258","W01000258",174,2153,1081,1072,382,1771,4.848,2.977,0,8.96,22.588,39.373,"W01000258"
"259","W01000259",71,1636,788,848,301,1335,2.527,0,0,1.774,3.668,7.969,"W01000259"
"260","W01000260",9,1809,880,929,356,1453,0,0,0,0.167,4.252,4.419,"W01000260"
"261","W01000261",26,1549,761,788,284,1265,0.855,0,0,0.193,3.317,4.365,"W01000261"
"262","W01000262",16,1490,722,768,374,1116,0.121,0,0,0.857,3.709,4.687,"W01000262"
"263","W01000263",5,1488,745,743,347,1141,0,0,0,0.131,2.647,2.778,"W01000263"
"264","W01000264",21,1701,844,857,466,1235,0.239,0.078,0,1.753,4.534,6.604,"W01000264"
"265","W01000265",40,1312,639,673,225,1087,1.483,0,0,1.594,5.387,8.464,"W01000265"
"266","W01000266",14,1320,654,666,235,1085,0.164,0.697,0,0.419,3.856,5.136,"W01000266"
"267","W01000267",15,1593,787,806,322,1271,0.065,0,0,0.333,5.83,6.228,"W01000267"
"268","W01000268",14,1767,885,882,445,1322,0,0.812,0,1.123,5.607,7.542,"W01000268"
"269","W01000269",29,1619,791,828,275,1344,1.791,0,0,0.828,3.953,6.572,"W01000269"
"270","W01000270",30,1286,654,632,228,1058,2.409,2.813,0,13.063,32.387,50.672,"W01000270"
"271","W01000271",54,1283,630,653,239,1044,2.241,4.726,0,9.322,20.312,36.601,"W01000271"
"272","W01000272",105,1874,921,953,339,1535,7.942,0.501,0,26.202,47.989,82.634,"W01000272"
"273","W01000273",21,1585,764,821,351,1234,0,0.256,0,0.046,3.844,4.146,"W01000273"
"274","W01000274",57,1771,892,879,425,1346,0.351,0.857,0,6.82,4.741,12.769,"W01000274"
"275","W01000275",66,1253,646,607,271,982,2.414,1.069,0,8.178,3.608,15.269,"W01000275"
"276","W01000276",2,1393,709,684,391,1002,0,0,0,0,2.851,2.851,"W01000276"
"277","W01000277",20,1363,636,727,329,1034,0,0,0,0.25,5.414,5.664,"W01000277"
"278","W01000278",25,1495,723,772,414,1081,0,0.242,0,0,1.71,1.952,"W01000278"
"279","W01000279",29,1264,604,660,209,1055,0,0,0,0.251,3.044,3.295,"W01000279"
"280","W01000280",18,1426,713,713,300,1126,0,0,0,0.206,5.236,5.442,"W01000280"
"281","W01000281",11,1222,611,611,235,987,0,0.232,0,0,2.953,3.185,"W01000281"
"282","W01000282",20,1743,885,858,563,1180,0,0.909,0,0,3.907,4.816,"W01000282"
"283","W01000283",80,2259,1120,1139,453,1806,0,0.872,0,10.278,6.879,18.029,"W01000283"
"284","W01000284",16,1708,845,863,403,1305,0,0,0,0.395,4.67,5.065,"W01000284"
"285","W01000285",63,1473,715,758,273,1200,0.205,0.43,0,0.997,6.037,7.669,"W01000285"
"286","W01000286",147,2239,1115,1124,580,1659,4.598,2.463,0,1.654,7.965,16.68,"W01000286"
"287","W01000287",48,1808,885,923,338,1470,3.637,0,0,20.531,14.694,38.862,"W01000287"
"288","W01000288",69,2264,1073,1191,525,1739,0.549,0,0,0.196,7.845,8.59,"W01000288"
"289","W01000289",24,1358,683,675,313,1045,0.2,0,0,1.575,4.77,6.545,"W01000289"
"290","W01000290",62,1269,622,647,227,1042,0.961,0,0,0.846,3.104,4.911,"W01000290"
"291","W01000291",4,1401,665,736,327,1074,0,0,0,0.306,3.755,4.061,"W01000291"
"292","W01000292",27,1483,706,777,419,1064,0,0,0,0,1.753,1.753,"W01000292"
"293","W01000293",57,1568,825,743,338,1230,2.415,0,0,4.27,4.653,11.338,"W01000293"
"294","W01000294",47,1937,992,945,424,1513,2.316,0,0,1.275,9.547,13.138,"W01000294"
"295","W01000295",28,1673,801,872,363,1310,0.492,0,0,0.085,2.275,2.852,"W01000295"
"296","W01000296",38,1506,748,758,346,1160,2.237,0.672,0,4.409,4.618,11.936,"W01000296"
"297","W01000297",10,1235,592,643,329,906,0,0.131,0,0.478,3.351,3.96,"W01000297"
"298","W01000298",73,1527,762,765,304,1223,1.162,0,0,5.717,9.743,16.622,"W01000298"
"299","W01000299",23,1942,955,987,338,1604,0,0,0,7.129,19.314,26.443,"W01000299"
"300","W01000300",67,1726,846,880,295,1431,2.251,0.117,0,8.328,31.335,42.031,"W01000300"
"301","W01000301",95,1785,889,896,344,1441,1.833,4.895,0,26.497,35.048,68.273,"W01000301"
"302","W01000302",93,1887,889,998,352,1535,2.703,0.924,0,2.984,6.229,12.84,"W01000302"
"303","W01000303",26,1697,816,881,388,1309,0.002,0,0,2.532,15.718,18.252,"W01000303"
"304","W01000304",83,1988,966,1022,488,1500,2.317,1.036,0,0.638,5.532,9.523,"W01000304"
"305","W01000305",48,1758,874,884,368,1390,1.577,0,0,1.42,4.759,7.756,"W01000305"
"306","W01000306",79,2399,1211,1188,557,1842,2.079,0.642,0,2.44,5.913,11.074,"W01000306"
"307","W01000307",103,1363,670,693,290,1073,4.793,0.459,0,4.248,17.771,27.271,"W01000307"
"308","W01000308",26,1242,616,626,274,968,0.895,0.175,0,0.86,3.582,5.512,"W01000308"
"309","W01000309",132,2135,1064,1071,464,1671,4.617,0.876,0,3.251,13.146,21.89,"W01000309"
"310","W01000310",89,1850,917,933,346,1504,0.985,6.152,0,16.349,29.984,53.47,"W01000310"
"311","W01000311",69,1782,901,881,355,1427,0.058,1.148,0,0.578,6.077,7.861,"W01000311"
"312","W01000312",49,1714,851,863,357,1357,0.002,0.27,0,0.991,3.143,4.406,"W01000312"
"313","W01000313",16,1566,729,837,381,1185,0.027,1.075,0,2.166,6.992,10.26,"W01000313"
"314","W01000314",50,1129,548,581,196,933,0.641,0,0,0.257,3.035,3.933,"W01000314"
"315","W01000315",118,2006,963,1043,410,1596,3.513,0.133,0,1.79,8.587,14.023,"W01000315"
"316","W01000316",4,1323,620,703,270,1053,0,0,0,0.234,3.58,3.814,"W01000316"
"317","W01000317",2,1393,708,685,337,1056,0.54,0,0,0.282,5.122,5.944,"W01000317"
"318","W01000318",1,1172,579,593,348,824,0,0,0,0.037,1.789,1.826,"W01000318"
"319","W01000319",41,1469,733,736,262,1207,1.161,0.429,0,0.298,4.466,6.354,"W01000319"
"320","W01000320",67,1844,902,942,412,1432,4.845,0,0,12.655,15.703,33.203,"W01000320"
"321","W01000321",5,1659,808,851,323,1336,0.124,0,0,0.262,3.773,4.159,"W01000321"
"322","W01000322",32,1342,642,700,240,1102,0.588,0,0,0.267,3.345,4.2,"W01000322"
"323","W01000323",110,1545,760,785,291,1254,6.083,2.836,0,7.436,10.006,26.361,"W01000323"
"324","W01000324",16,1504,716,788,338,1166,0.639,0,0,0.264,5.517,6.42,"W01000324"
"325","W01000325",71,1530,745,785,285,1245,0.657,2.611,0,1.557,6.625,11.45,"W01000325"
"326","W01000326",23,1677,814,863,337,1340,1.336,0,0,1.764,8.335,11.435,"W01000326"
"327","W01000327",172,2197,1111,1086,441,1756,5.994,0,0,1.967,12.763,20.724,"W01000327"
"328","W01000328",149,2109,1106,1003,412,1697,1.085,2.561,0,4.988,10.554,19.188,"W01000328"
"329","W01000329",61,1373,674,699,330,1043,0.84,2.924,0,3.221,3.681,10.666,"W01000329"
"330","W01000330",38,2150,1068,1082,555,1595,0.497,0,0,0.089,3.173,3.759,"W01000330"
"331","W01000331",30,1609,799,810,328,1281,0,0,0,0.186,3.852,4.038,"W01000331"
"332","W01000332",257,1568,792,776,354,1214,10.063,1.817,0,15.824,20.284,47.988,"W01000332"
"333","W01000333",55,1428,700,728,360,1068,0.19,0.697,0,7.427,4.074,12.388,"W01000333"
"334","W01000334",31,1958,994,964,391,1567,0,0.623,0,1.164,4.527,6.314,"W01000334"
"335","W01000335",30,1111,526,585,236,875,0,0,0,0.413,4.069,4.482,"W01000335"
"336","W01000336",51,1465,712,753,443,1022,0.173,0.006,0,0.369,3.191,3.739,"W01000336"
"337","W01000337",52,2129,1080,1049,421,1708,0,0.374,0,1.119,5.941,7.434,"W01000337"
"338","W01000338",80,1838,888,950,352,1486,3.436,0,0,9.552,31.487,44.475,"W01000338"
"339","W01000339",64,1627,800,827,326,1301,5.725,0.743,0,6.988,22.69,36.146,"W01000339"
"340","W01000340",134,2322,1186,1136,452,1870,10.088,0,0,10.874,30.131,51.093,"W01000340"
"341","W01000341",18,1582,749,833,353,1229,0,0.096,0,0.174,4.17,4.44,"W01000341"
"342","W01000342",16,1583,745,838,325,1258,0,0.027,0,0.08,4.347,4.454,"W01000342"
"343","W01000343",19,1054,510,544,167,887,0.034,0,0,0,3.764,3.798,"W01000343"
"344","W01000344",13,1305,630,675,200,1105,0,0,0,0,5.09,5.09,"W01000344"
"345","W01000345",37,1583,783,800,289,1294,2.119,7.133,0,5.3,16.637,31.189,"W01000345"
"346","W01000346",92,1596,786,810,343,1253,11.081,0,0,14.584,48.723,74.388,"W01000346"
"347","W01000347",52,2524,1272,1252,564,1960,0,2.803,0,2.636,16.045,21.484,"W01000347"
"348","W01000348",16,1457,713,744,384,1073,0,0,0,0.668,3.943,4.611,"W01000348"
"349","W01000349",145,1853,934,919,364,1489,1.747,0.854,0,1.264,5.064,8.929,"W01000349"
"350","W01000350",175,1595,870,725,246,1349,0.776,0.003,0,1.107,3.688,5.574,"W01000350"
"351","W01000351",27,2175,1066,1109,470,1705,0,1.037,0,0.74,8.914,10.691,"W01000351"
"352","W01000352",14,1007,502,505,198,809,0.079,0,0,0.145,1.878,2.102,"W01000352"
"353","W01000353",11,1386,682,704,417,969,0,0,0,0.238,3.455,3.693,"W01000353"
"354","W01000354",28,1731,871,860,331,1400,0.795,0,0,6.132,8.686,15.613,"W01000354"
"355","W01000355",43,1614,821,793,307,1307,0.093,0.96,0,2.042,3.896,6.991,"W01000355"
"356","W01000356",20,1729,861,868,444,1285,0,0.935,0,0.957,4.025,5.917,"W01000356"
"357","W01000357",25,NA,NA,NA,NA,NA,NA,NA,NA,NA,NA,NA,NA
"358","W01000358",8,NA,NA,NA,NA,NA,NA,NA,NA,NA,NA,NA,NA
"359","W01000359",70,1177,562,615,235,942,1.428,1.813,0,2.787,4.658,10.686,"W01000359"
"360","W01000360",6,1255,615,640,303,952,0,0,0,0.287,2.753,3.04,"W01000360"
"361","W01000361",98,2036,978,1058,437,1599,0.407,2.318,0,13.611,21.647,37.983,"W01000361"
"362","W01000362",13,1529,746,783,393,1136,0.001,0.061,0,0.647,4.243,4.952,"W01000362"
"363","W01000363",20,1524,740,784,287,1237,0.4,0.729,0,0.158,3.73,5.017,"W01000363"
"364","W01000364",101,1649,853,796,342,1307,3.161,0,0,3.277,8.266,14.704,"W01000364"
"365","W01000365",41,2200,1125,1075,346,1854,0.139,0.637,0,0.288,6.163,7.227,"W01000365"
"366","W01000366",28,1454,725,729,331,1123,0.054,0.218,0,0.101,3.87,4.243,"W01000366"
"367","W01000367",36,1312,677,635,302,1010,0.378,0.165,0,0.546,3.045,4.134,"W01000367"
"368","W01000368",29,2036,1004,1032,359,1677,0.843,0,0,0.124,6.023,6.99,"W01000368"
"369","W01000369",12,1270,602,668,223,1047,0,0.554,0,1.135,4.917,6.606,"W01000369"
"370","W01000370",72,1460,692,768,256,1204,1.088,2.451,0,2.552,6.944,13.035,"W01000370"
"371","W01000371",40,1204,617,587,212,992,0.137,0.37,0,0.185,1.653,2.345,"W01000371"
"372","W01000372",231,1486,762,724,179,1307,1.165,0.837,0,1.547,3.562,7.111,"W01000372"
"373","W01000373",46,1831,904,927,467,1364,0,1.14,0,0.714,3.459,5.313,"W01000373"
"374","W01000374",15,1386,675,711,296,1090,0,0,0,0.14,4.054,4.194,"W01000374"
"375","W01000375",127,1997,977,1020,514,1483,1.495,0.712,0,0.938,7.743,10.888,"W01000375"
"376","W01000376",32,1390,706,684,284,1106,0.476,0.09,0,0.666,3.096,4.328,"W01000376"
"377","W01000377",24,1540,771,769,348,1192,0.309,0,0,1.233,7.691,9.233,"W01000377"
"378","W01000378",37,1324,621,703,386,938,0.42,0,0,0.621,3.403,4.444,"W01000378"
"379","W01000379",10,1598,801,797,349,1249,0,0,0,0.576,4.752,5.328,"W01000379"
"380","W01000380",52,1442,718,724,237,1205,0,0,0,0.901,5.438,6.339,"W01000380"
"381","W01000381",14,1130,572,558,192,938,0,0,0,0,2.486,2.486,"W01000381"
"382","W01000382",45,1075,548,527,213,862,0.299,0.006,0,0.736,2.504,3.545,"W01000382"
"383","W01000383",255,2441,1228,1213,610,1831,5.744,7.187,0,16.965,57.835,87.731,"W01000383"
"384","W01000384",4,1113,528,585,199,914,0,1.052,0,0.487,3.514,5.053,"W01000384"
"385","W01000385",14,1750,873,877,331,1419,0,0.384,0,0.055,4.803,5.242,"W01000385"
"386","W01000386",13,1516,739,777,360,1156,0,0.845,0,0.432,4.953,6.23,"W01000386"
"387","W01000387",25,1257,606,651,244,1013,0.213,0,0,0.051,4.102,4.366,"W01000387"
"388","W01000388",2,1065,515,550,200,865,0.219,0,0,0,2.653,2.872,"W01000388"
"389","W01000389",28,2059,1028,1031,448,1611,3.169,1.751,0,4.079,16.393,25.392,"W01000389"
"390","W01000390",67,1669,832,837,304,1365,0,5.792,0,4.242,8.423,18.457,"W01000390"
"391","W01000391",53,1425,714,711,259,1166,0,1.301,0,1.439,5.252,7.992,"W01000391"
"392","W01000392",9,1720,831,889,468,1252,0,0.022,0,0.788,4.483,5.293,"W01000392"
"393","W01000393",81,1950,955,995,383,1567,0.96,0.101,0,0.484,6.116,7.661,"W01000393"
"394","W01000394",169,1279,657,622,263,1016,7.918,10.1,0,21.327,31.277,70.622,"W01000394"
"395","W01000395",32,1092,542,550,219,873,2.918,0,0,2.504,3.47,8.892,"W01000395"
"396","W01000396",10,1235,607,628,255,980,0,0.398,0,0.607,3.422,4.427,"W01000396"
"397","W01000397",8,1045,520,525,214,831,0,0.158,0,2.375,6.66,9.193,"W01000397"
"398","W01000398",21,1314,671,643,256,1058,1.006,3.942,0,3.626,7.135,15.709,"W01000398"
"399","W01000399",63,1158,584,574,232,926,2.558,3.037,0,3.268,9.381,18.244,"W01000399"
"400","W01000400",77,1657,814,843,360,1297,0,2.38,0,2.033,4.022,8.435,"W01000400"
"401","W01000401",15,1791,879,912,433,1358,0,1.18,0,0.396,5.29,6.866,"W01000401"
"402","W01000402",186,2648,1422,1226,430,2218,2.107,0.757,0,0.983,4.275,8.122,"W01000402"
"403","W01000403",43,1327,668,659,260,1067,8.766,0,0,11.21,37.025,57.001,"W01000403"
"404","W01000404",83,1988,984,1004,447,1541,10.773,3.079,0,12.767,22.711,49.33,"W01000404"
"405","W01000405",28,2335,1114,1221,638,1697,0,0.631,0,0.965,5.671,7.267,"W01000405"
"406","W01000406",12,2205,1093,1112,580,1625,0,0.618,0,1.532,4.908,7.058,"W01000406"
"407","W01000407",72,1349,659,690,260,1089,6.312,2.167,0,14.806,11.773,35.058,"W01000407"
"408","W01000408",14,1184,587,597,283,901,0,0.3,0,2.205,9.321,11.826,"W01000408"
"409","W01000409",24,1977,958,1019,629,1348,0,0,0,0.368,4.328,4.696,"W01000409"
"410","W01000410",120,1647,822,825,344,1303,3.401,3.159,0,3.443,7.469,17.472,"W01000410"
"411","W01000411",21,1599,779,820,346,1253,0,0.417,0,1.206,6.092,7.715,"W01000411"
"412","W01000412",22,1596,821,775,319,1277,0,4.321,0,4.055,11.713,20.089,"W01000412"
"413","W01000413",17,1422,683,739,540,882,0,0,0,0.053,2.246,2.299,"W01000413"
"414","W01000414",10,1263,627,636,390,873,0,0,0,0.102,3.272,3.374,"W01000414"
"415","W01000415",29,1484,730,754,243,1241,0.225,0.257,0,0.435,3.162,4.079,"W01000415"
"416","W01000416",7,1266,638,628,243,1023,0.081,0,0,0.203,3.465,3.749,"W01000416"
"417","W01000417",15,1568,783,785,316,1252,0,2.831,0,4.157,11.044,18.032,"W01000417"
"418","W01000418",78,1663,847,816,345,1318,2.202,3.043,0,6.067,15.536,26.848,"W01000418"
"419","W01000419",73,1539,774,765,403,1136,1.961,1.748,0,2.894,6.971,13.574,"W01000419"
"420","W01000420",37,1386,677,709,273,1113,0.089,0.943,0,1.558,4.996,7.586,"W01000420"
"421","W01000421",77,NA,NA,NA,NA,NA,NA,NA,NA,NA,NA,NA,NA
"422","W01000422",65,2114,1044,1070,355,1759,0,1.058,0,0.464,5.629,7.151,"W01000422"
"423","W01000423",27,2232,1102,1130,657,1575,0,0,0,0.767,5.225,5.992,"W01000423"
"424","W01000424",21,1264,636,628,228,1036,0.213,0,0,0.369,1.958,2.54,"W01000424"
"425","W01000425",38,2323,1150,1173,730,1593,0.28,0,0,0.161,6.142,6.583,"W01000425"
"426","W01000426",61,1424,701,723,263,1161,3.069,0.868,0,2.902,7.496,14.335,"W01000426"
"427","W01000427",98,1411,715,696,274,1137,16.25,28.382,0,99.876,106.051,250.559,"W01000427"
"428","W01000428",102,1334,683,651,230,1104,6.873,11.029,0,33.337,58.909,110.148,"W01000428"
"429","W01000429",227,2294,1182,1112,452,1842,24.543,19.801,0,280.072,178.624,503.04,"W01000429"
"430","W01000430",100,1282,632,650,251,1031,20.247,0.049,0,43.348,49.103,112.747,"W01000430"
"431","W01000431",21,1335,671,664,347,988,0.991,0.289,0,1.131,2.35,4.761,"W01000431"
"432","W01000432",7,1233,579,654,259,974,1.441,0.843,0,1.086,5.895,9.265,"W01000432"
"433","W01000433",172,2316,1163,1153,411,1905,15.602,9.818,0,70.461,58.945,154.826,"W01000433"
"434","W01000434",30,1691,845,846,328,1363,6.426,6.422,0,24.505,56.12,93.473,"W01000434"
"435","W01000435",36,NA,NA,NA,NA,NA,NA,NA,NA,NA,NA,NA,NA
"436","W01000436",25,NA,NA,NA,NA,NA,NA,NA,NA,NA,NA,NA,NA
"437","W01000437",43,NA,NA,NA,NA,NA,NA,NA,NA,NA,NA,NA,NA
"438","W01000438",85,1239,613,626,178,1061,8.705,0,0,19.561,29.611,57.877,"W01000438"
"439","W01000439",111,1972,977,995,419,1553,4.058,11.665,0,28.093,61.362,105.178,"W01000439"
"440","W01000440",126,1350,664,686,270,1080,9.635,8.24,0,38.132,102.782,158.789,"W01000440"
"441","W01000441",71,1426,702,724,301,1125,4.195,8.241,0,30.512,29.173,72.121,"W01000441"
"442","W01000442",132,2040,1009,1031,377,1663,25.455,7.279,0,260.433,116.495,409.662,"W01000442"
"443","W01000443",58,2299,1131,1168,417,1882,10.809,22.459,0,64.099,132.71,230.077,"W01000443"
"444","W01000444",96,2319,1129,1190,453,1866,8.498,19.095,0,35.476,55.487,118.556,"W01000444"
"445","W01000445",70,1527,775,752,287,1240,4.665,4.488,0,20.106,67.897,97.156,"W01000445"
"446","W01000446",23,1598,769,829,275,1323,0,1.985,0,1.052,5.473,8.51,"W01000446"
"447","W01000447",195,2057,1036,1021,437,1620,20.097,14.69,0,57.141,76.057,167.985,"W01000447"
"448","W01000448",20,1406,676,730,275,1131,1.168,3.364,0,5.791,16.147,26.47,"W01000448"
"449","W01000449",34,1601,816,785,297,1304,5.102,0.803,0,6.715,11.479,24.099,"W01000449"
"450","W01000450",119,1386,687,699,256,1130,9.161,17.385,0,90.02,121.608,238.174,"W01000450"
"451","W01000451",86,1129,550,579,242,887,15.272,0,0,25.358,37.369,77.999,"W01000451"
"452","W01000452",121,1931,1001,930,371,1560,20.694,15.975,0,242.635,128.121,407.425,"W01000452"
"453","W01000453",142,1405,712,693,268,1137,11.089,0,0,74.66,78.09,163.839,"W01000453"
"454","W01000454",35,1227,622,605,186,1041,2.246,0,0,1.341,4.528,8.115,"W01000454"
"455","W01000455",17,2059,1001,1058,481,1578,2.169,0,0,2.401,8.661,13.231,"W01000455"
"456","W01000456",21,2023,964,1059,352,1671,1.611,0,0,8.156,13.812,23.579,"W01000456"
"457","W01000457",87,2191,1090,1101,484,1707,4.28,11.407,0,24.848,40.34,80.875,"W01000457"
"458","W01000458",56,1789,888,901,363,1426,1.846,5.535,0,9.936,23.356,40.673,"W01000458"
"459","W01000459",95,1206,598,608,246,960,19.311,6.862,0,59.295,69.584,155.052,"W01000459"
"460","W01000460",98,1810,891,919,434,1376,9.8,8.514,0,40.344,68.226,126.884,"W01000460"
"461","W01000461",25,1532,806,726,299,1233,4.123,6.197,0,29.486,38.525,78.331,"W01000461"
"462","W01000462",29,NA,NA,NA,NA,NA,NA,NA,NA,NA,NA,NA,NA
"463","W01000463",102,NA,NA,NA,NA,NA,NA,NA,NA,NA,NA,NA,NA
"464","W01000464",108,1255,629,626,219,1036,17.66,15.122,0,110.41,69.805,212.997,"W01000464"
"465","W01000465",58,1036,506,530,182,854,0,7.979,0,10.798,24.067,42.844,"W01000465"
"466","W01000466",13,1425,664,761,301,1124,0.324,1.717,0,1.526,4.179,7.746,"W01000466"
"467","W01000467",30,1504,779,725,216,1288,0.378,3.379,0,5.545,5.458,14.76,"W01000467"
"468","W01000468",26,NA,NA,NA,NA,NA,NA,NA,NA,NA,NA,NA,NA
"469","W01000469",47,NA,NA,NA,NA,NA,NA,NA,NA,NA,NA,NA,NA
"470","W01000470",81,1880,914,966,334,1546,5.599,7.735,0,30.267,53.866,97.467,"W01000470"
"471","W01000471",88,1875,949,926,334,1541,18.278,5.204,0,270.405,109.367,403.254,"W01000471"
"472","W01000472",57,1141,568,573,193,948,10.27,3.725,0,16.594,26.951,57.54,"W01000472"
"473","W01000473",31,2235,1074,1161,451,1784,2.835,0,0,6.962,9.192,18.989,"W01000473"
"474","W01000474",149,1703,851,852,307,1396,33.069,0,0,116.034,150.218,299.321,"W01000474"
"475","W01000475",94,2371,1178,1193,433,1938,20.739,26.226,0,86.832,151.722,285.519,"W01000475"
"476","W01000476",18,1295,616,679,251,1044,0,7.782,0,5.335,12.74,25.857,"W01000476"
"477","W01000477",129,1465,740,725,266,1199,27.105,12.614,0,163.271,118.21,321.2,"W01000477"
"478","W01000478",21,1755,862,893,554,1201,0.182,0,0,0.07,4.696,4.948,"W01000478"
"479","W01000479",24,1523,722,801,414,1109,0.798,0,0,0.348,3.007,4.153,"W01000479"
"480","W01000480",167,2069,1023,1046,414,1655,6.098,0.563,0,5.682,14.005,26.348,"W01000480"
"481","W01000481",24,2267,1102,1165,409,1858,0,3.609,0,6.208,12.177,21.994,"W01000481"
"482","W01000482",32,1844,937,907,378,1466,0,3.876,0,5.942,13.119,22.937,"W01000482"
"483","W01000483",52,1899,914,985,567,1332,2.953,0,0,1.966,10.271,15.19,"W01000483"
"484","W01000484",109,1562,803,759,266,1296,16.088,25.503,0,62.141,81.222,184.954,"W01000484"
"485","W01000485",30,1547,732,815,216,1331,0,9.582,0,17.546,19.516,46.644,"W01000485"
"486","W01000486",6,1163,587,576,268,895,0,4.006,0,3.262,3.656,10.924,"W01000486"
"487","W01000487",34,2088,997,1091,363,1725,2.109,5.69,0,34.854,76.194,118.847,"W01000487"
"488","W01000488",38,2180,1128,1052,432,1748,0,15.51,0,72.015,116.669,204.194,"W01000488"
"489","W01000489",46,1797,877,920,477,1320,0.788,1.234,0,3.133,8.35,13.505,"W01000489"
"490","W01000490",10,NA,NA,NA,NA,NA,NA,NA,NA,NA,NA,NA,NA
"491","W01000491",12,NA,NA,NA,NA,NA,NA,NA,NA,NA,NA,NA,NA
"492","W01000492",35,1591,782,809,266,1325,0,2.318,0,1.252,4.968,8.538,"W01000492"
"493","W01000493",51,1520,778,742,350,1170,0.652,2.818,0,7.463,6.377,17.31,"W01000493"
"494","W01000494",101,1724,849,875,346,1378,12.202,2.812,0,10.357,47.514,72.885,"W01000494"
"495","W01000495",279,NA,NA,NA,NA,NA,NA,NA,NA,NA,NA,NA,NA
"496","W01000496",80,2118,1057,1061,392,1726,8.552,0,0,54.095,46.52,109.167,"W01000496"
"497","W01000497",145,1430,715,715,342,1088,6.954,1.501,0,19.069,32.354,59.878,"W01000497"
"498","W01000498",91,1538,746,792,340,1198,6.866,0.204,0,29.496,14.231,50.797,"W01000498"
"499","W01000499",61,1290,626,664,258,1032,1.662,0.476,0,1.256,2.359,5.753,"W01000499"
"500","W01000500",55,1536,767,769,324,1212,6.011,0,0,9.113,8.638,23.762,"W01000500"
"501","W01000501",37,2300,1134,1166,447,1853,2.787,0.6,0,9.646,13.433,26.466,"W01000501"
"502","W01000502",100,2071,992,1079,342,1729,0.134,3.232,0,3.832,10.497,17.695,"W01000502"
"503","W01000503",44,1038,509,529,192,846,3.762,10.595,0,67.878,101.628,183.863,"W01000503"
"504","W01000504",9,1161,587,574,267,894,0.003,0.384,0,0.291,3.056,3.734,"W01000504"
"505","W01000505",21,1383,660,723,229,1154,0.472,0.376,0,9.148,6.38,16.376,"W01000505"
"506","W01000506",35,1422,673,749,203,1219,2.925,0,0,4.351,8.217,15.493,"W01000506"
"507","W01000507",42,1196,582,614,183,1013,3.428,5.203,0,16.354,12.177,37.162,"W01000507"
"508","W01000508",6,1178,591,587,235,943,0,0,0,12.428,5.799,18.227,"W01000508"
"509","W01000509",14,1784,833,951,340,1444,0.343,2.19,0,1.69,9.474,13.697,"W01000509"
"510","W01000510",50,1226,595,631,224,1002,1.96,1.083,0,3.399,4.512,10.954,"W01000510"
"511","W01000511",101,1174,595,579,281,893,3.059,0.992,0,3.445,7.511,15.007,"W01000511"
"512","W01000512",34,2075,1105,970,167,1908,0.816,0,0,2.6,2.448,5.864,"W01000512"
"513","W01000513",79,2471,1328,1143,112,2359,0.677,0.529,0,0.887,2.647,4.74,"W01000513"
"514","W01000514",19,NA,NA,NA,NA,NA,NA,NA,NA,NA,NA,NA,NA
"515","W01000515",16,1446,727,719,335,1111,0.491,0,0,0.674,2.805,3.97,"W01000515"
"516","W01000516",43,1676,836,840,413,1263,0.906,0,0,1.215,3.642,5.763,"W01000516"
"517","W01000517",23,1472,807,665,108,1364,0.014,0.05,0,0.236,3.163,3.463,"W01000517"
"518","W01000518",22,1259,629,630,156,1103,0.374,0,0,3.351,2.605,6.33,"W01000518"
"519","W01000519",106,1627,800,827,255,1372,5.858,13.419,0,41.778,60.697,121.752,"W01000519"
"520","W01000520",28,NA,NA,NA,NA,NA,NA,NA,NA,NA,NA,NA,NA
"521","W01000521",15,NA,NA,NA,NA,NA,NA,NA,NA,NA,NA,NA,NA
"522","W01000522",44,1293,655,638,213,1080,6.68,12.019,0,44.815,47.558,111.072,"W01000522"
"523","W01000523",92,1910,972,938,397,1513,11.937,4.525,0,121.789,62.475,200.726,"W01000523"
"524","W01000524",102,1974,986,988,387,1587,10.396,4.031,0,30.461,48.051,92.939,"W01000524"
"525","W01000525",25,1206,556,650,176,1030,0.599,0,0,3.698,5.901,10.198,"W01000525"
"526","W01000526",49,NA,NA,NA,NA,NA,NA,NA,NA,NA,NA,NA,NA
"527","W01000527",30,1510,807,703,190,1320,1.333,0,0,2.126,2.055,5.514,"W01000527"
"528","W01000528",26,1460,700,760,296,1164,5.427,0,0,8.423,8.236,22.086,"W01000528"
"529","W01000529",126,1616,826,790,344,1272,8.37,8.926,0,29.863,48.816,95.975,"W01000529"
"530","W01000530",66,NA,NA,NA,NA,NA,NA,NA,NA,NA,NA,NA,NA
"531","W01000531",49,1835,879,956,353,1482,9.364,8.121,0,32.806,31.096,81.387,"W01000531"
"532","W01000532",90,1979,979,1000,343,1636,11.395,7.699,0,55.45,71.282,145.826,"W01000532"
"533","W01000533",26,1439,691,748,295,1144,1.262,5.016,0,5.576,9.188,21.042,"W01000533"
"534","W01000534",175,1541,756,785,328,1213,14.048,3.885,0,26.652,29.113,73.698,"W01000534"
"535","W01000535",82,2037,1025,1012,394,1643,6.203,33.016,0,48.773,55.919,143.911,"W01000535"
"536","W01000536",41,1459,715,744,260,1199,2.88,21.467,0,99.312,64.695,188.354,"W01000536"
"537","W01000537",68,1484,736,748,263,1221,11.986,6.27,0,48.71,66.048,133.014,"W01000537"
"538","W01000538",126,1562,773,789,324,1238,4.991,12.173,0,39.335,69.52,126.019,"W01000538"
"539","W01000539",54,1222,628,594,209,1013,0.627,15.199,0,30.886,37.866,84.578,"W01000539"
"540","W01000540",80,1164,559,605,195,969,6.144,0.362,0,10.035,8.933,25.474,"W01000540"
"541","W01000541",94,1854,893,961,354,1500,8.67,18.003,0,45.035,59.297,131.005,"W01000541"
"542","W01000542",70,2209,1085,1124,426,1783,7.743,18.435,0,141.283,100.33,267.791,"W01000542"
"543","W01000543",236,2020,999,1021,388,1632,34.603,17.468,0,123.706,150.769,326.546,"W01000543"
"544","W01000544",9,1082,526,556,206,876,0.808,1.837,0,7.717,6.671,17.033,"W01000544"
"545","W01000545",83,2045,1016,1029,315,1730,9.332,13.728,0,48.008,78.445,149.513,"W01000545"
"546","W01000546",42,1128,562,566,177,951,4.316,5.844,0,17.63,19.29,47.08,"W01000546"
"547","W01000547",49,1180,558,622,220,960,3.676,1.44,0,17.674,34.667,57.457,"W01000547"
"548","W01000548",81,1901,911,990,426,1475,2.511,3.744,0,18.226,12.686,37.167,"W01000548"
"549","W01000549",39,1771,902,869,373,1398,0.981,0,0,23.74,42.989,67.71,"W01000549"
"550","W01000550",22,1213,595,618,234,979,6.499,8.099,0,61.265,44.068,119.931,"W01000550"
"551","W01000551",37,1310,639,671,249,1061,4.928,10.012,0,20.565,39.502,75.007,"W01000551"
"552","W01000552",99,2074,1038,1036,469,1605,7.366,18.055,0,60.027,56.957,142.405,"W01000552"
"553","W01000553",90,1232,609,623,180,1052,4.853,0,0,20.274,35.493,60.62,"W01000553"
"554","W01000554",51,1826,880,946,354,1472,0.339,0,0,18.558,28.498,47.395,"W01000554"
"555","W01000555",93,1416,726,690,238,1178,4.872,11.204,0,26.911,39.429,82.416,"W01000555"
"556","W01000556",35,1149,552,597,179,970,5.714,0,0,12.115,33.512,51.341,"W01000556"
"557","W01000557",100,1532,748,784,362,1170,9.338,1.028,0,8.624,33.995,52.985,"W01000557"
"558","W01000558",75,2058,1002,1056,424,1634,7.164,4.929,0,37.276,47.878,97.247,"W01000558"
"559","W01000559",62,1451,746,705,256,1195,3.762,4.684,0,46.357,85.192,139.995,"W01000559"
"560","W01000560",109,1207,630,577,214,993,7.691,10.374,0,38.218,44.746,101.029,"W01000560"
"561","W01000561",43,1256,629,627,280,976,4.362,0,0,24.864,30.574,59.8,"W01000561"
"562","W01000562",57,1696,837,859,288,1408,5.483,16.318,0,48.949,79.611,150.361,"W01000562"
"563","W01000563",75,1207,597,610,248,959,6.613,5.06,0,11.585,21.525,44.783,"W01000563"
"564","W01000564",42,1211,598,613,201,1010,1.721,0.392,0,4.497,3.203,9.813,"W01000564"
"565","W01000565",13,1873,881,992,328,1545,1.046,0.945,0,2.705,5.743,10.439,"W01000565"
"566","W01000566",41,1546,742,804,303,1243,3.075,0,0,2.201,5.96,11.236,"W01000566"
"567","W01000567",13,1988,997,991,414,1574,1.782,0,0,7.332,11.176,20.29,"W01000567"
"568","W01000568",62,2301,1168,1133,446,1855,0.422,0.464,0,1.097,7.245,9.228,"W01000568"
"569","W01000569",26,1327,642,685,369,958,0.512,0.645,0,0.232,2.76,4.149,"W01000569"
"570","W01000570",14,1474,691,783,508,966,0,0,0,0.041,3.796,3.837,"W01000570"
"571","W01000571",55,2260,1068,1192,444,1816,0.24,1.54,0,1.513,5.741,9.034,"W01000571"
"572","W01000572",43,1850,873,977,405,1445,1.629,1.198,0,4.111,6.33,13.268,"W01000572"
"573","W01000573",157,2496,1164,1332,525,1971,1.151,0,0,0.837,11.535,13.523,"W01000573"
"574","W01000574",89,1877,938,939,353,1524,0,28.135,0,104.495,87.925,220.555,"W01000574"
"575","W01000575",193,2517,1177,1340,522,1995,4.887,2.673,0,12.094,27.014,46.668,"W01000575"
"576","W01000576",80,2262,1116,1146,475,1787,7.228,0.105,0,15.989,26.463,49.785,"W01000576"
"577","W01000577",85,1598,774,824,302,1296,7.405,6.387,0,37.977,45.316,97.085,"W01000577"
"578","W01000578",82,1671,830,841,279,1392,8.068,2.684,0,20.693,31.837,63.282,"W01000578"
"579","W01000579",78,2352,1154,1198,526,1826,8.781,7.619,0,22.481,60.579,99.46,"W01000579"
"580","W01000580",72,2336,1137,1199,515,1821,0,0,0,5.756,23.33,29.086,"W01000580"
"581","W01000581",27,1464,732,732,252,1212,9.371,6.367,0,23.116,57.443,96.297,"W01000581"
"582","W01000582",28,1659,808,851,327,1332,0,9.919,0,44.429,83.181,137.529,"W01000582"
"583","W01000583",31,1445,701,744,334,1111,6.566,2.752,0,23.44,30.105,62.863,"W01000583"
"584","W01000584",94,2083,1024,1059,441,1642,4.888,4.446,0,21.609,36.488,67.431,"W01000584"
"585","W01000585",205,1408,702,706,252,1156,12.335,3.748,0,58.523,76.136,150.742,"W01000585"
"586","W01000586",97,2202,1059,1143,527,1675,1.861,0,0,5.56,10.414,17.835,"W01000586"
"587","W01000587",86,2003,1003,1000,345,1658,1.069,0.497,0,2.443,5.893,9.902,"W01000587"
"588","W01000588",39,2157,1044,1113,559,1598,0.327,1.752,0,11.098,9.129,22.306,"W01000588"
"589","W01000589",30,1152,557,595,270,882,0.007,0,0,0.371,3.328,3.706,"W01000589"
"590","W01000590",2,1087,510,577,152,935,0,0,0,0.385,3.545,3.93,"W01000590"
"591","W01000591",30,1187,555,632,268,919,0,0,0,2.971,10.433,13.404,"W01000591"
"592","W01000592",14,1304,636,668,346,958,0,0,0,0.255,4.043,4.298,"W01000592"
"593","W01000593",114,2763,1355,1408,605,2158,1.483,0,0,1.632,11.574,14.689,"W01000593"
"594","W01000594",27,2254,1142,1112,545,1709,0.111,0,0,0.839,5.318,6.268,"W01000594"
"595","W01000595",29,1923,894,1029,383,1540,1.495,1.272,0,1.064,4.597,8.428,"W01000595"
"596","W01000596",107,1509,723,786,303,1206,10.792,4.765,0,19.084,17.158,51.799,"W01000596"
"597","W01000597",31,1161,520,641,203,958,4.039,0,0,13.439,15.045,32.523,"W01000597"
"598","W01000598",17,2219,1055,1164,428,1791,0.12,1.687,0,1.762,8.922,12.491,"W01000598"
"599","W01000599",136,2150,1042,1108,493,1657,3.964,3.662,0,18.627,18.816,45.069,"W01000599"
"600","W01000600",45,1658,851,807,348,1310,0.765,0.046,0,1.121,2.963,4.895,"W01000600"
"601","W01000601",105,1544,720,824,452,1092,2.645,0,0,1.364,6.625,10.634,"W01000601"
"602","W01000602",30,1306,641,665,250,1056,0.726,0.218,0,1.29,5.124,7.358,"W01000602"
"603","W01000603",71,1897,949,948,458,1439,0.484,0.941,0,2.606,6.839,10.87,"W01000603"
"604","W01000604",13,1514,757,757,392,1122,0,0.51,0,0.484,5.254,6.248,"W01000604"
"605","W01000605",15,1834,923,911,452,1382,0,0.164,0,0.659,6.111,6.934,"W01000605"
"606","W01000606",23,1650,770,880,495,1155,0,1.185,0,1.223,4.138,6.546,"W01000606"
"607","W01000607",54,2060,1006,1054,517,1543,0.999,0.169,0,2.017,7.789,10.974,"W01000607"
"608","W01000608",47,1434,724,710,272,1162,1.468,1.149,0,0.562,4.405,7.584,"W01000608"
"609","W01000609",30,2408,1144,1264,380,2028,2.298,0.191,0,4.68,13.232,20.401,"W01000609"
"610","W01000610",94,1710,814,896,278,1432,5.235,3.373,0,33.591,20.657,62.856,"W01000610"
"611","W01000611",137,1664,812,852,272,1392,9.553,5.449,0,20.76,33.72,69.482,"W01000611"
"612","W01000612",47,1841,914,927,332,1509,10.739,3.05,0,26.112,51.499,91.4,"W01000612"
"613","W01000613",34,2218,1091,1127,400,1818,3.52,10.534,0,67.589,89.542,171.185,"W01000613"
"614","W01000614",30,1405,688,717,253,1152,0,5.662,0,22.955,53.519,82.136,"W01000614"
"615","W01000615",39,1535,763,772,267,1268,0.892,0.209,0,4.798,9.944,15.843,"W01000615"
"616","W01000616",22,1093,536,557,178,915,0,2.029,0,5.859,9.124,17.012,"W01000616"
"617","W01000617",82,1487,745,742,329,1158,12.975,0,0,34.141,74.565,121.681,"W01000617"
"618","W01000618",43,1877,1046,831,343,1534,7.773,3.121,0,24.694,66.715,102.303,"W01000618"
"619","W01000619",47,2112,979,1133,402,1710,2.724,0.445,0,3.827,5.579,12.575,"W01000619"
"620","W01000620",31,1030,529,501,134,896,0.903,0,0,0.626,1.61,3.139,"W01000620"
"621","W01000621",33,1554,732,822,292,1262,1.485,0.05,0,8.811,4.337,14.683,"W01000621"
"622","W01000622",104,1536,751,785,316,1220,0,11.344,0,25.112,53.772,90.228,"W01000622"
"623","W01000623",69,1973,970,1003,425,1548,0.238,7.106,0,33.812,85.389,126.545,"W01000623"
"624","W01000624",133,2315,1153,1162,473,1842,14.149,0.254,0,70.733,73.9,159.036,"W01000624"
"625","W01000625",35,1200,575,625,303,897,0.487,0,0,1.652,3.624,5.763,"W01000625"
"626","W01000626",91,1462,717,745,289,1173,1.393,0,0,1.916,5.382,8.691,"W01000626"
"627","W01000627",65,2175,1063,1112,474,1701,0.297,0,0,6.959,17.808,25.064,"W01000627"
"628","W01000628",114,1593,782,811,300,1293,0.517,0.6,0,2.59,7.209,10.916,"W01000628"
"629","W01000629",34,1731,834,897,374,1357,0.007,0,0,2.119,3.617,5.743,"W01000629"
"630","W01000630",14,1661,819,842,392,1269,0,0,0,2.292,3.522,5.814,"W01000630"
"631","W01000631",32,1776,874,902,434,1342,0,0.026,0,1.051,4.459,5.536,"W01000631"
"632","W01000632",10,1457,718,739,335,1122,0.14,0,0,0.276,2.759,3.175,"W01000632"
"633","W01000633",32,1412,692,720,256,1156,0,2.178,0,4.732,5.498,12.408,"W01000633"
"634","W01000634",23,1377,667,710,208,1169,1.262,0.6,0,2.425,5.459,9.746,"W01000634"
"635","W01000635",77,2265,1103,1162,482,1783,1.694,2.764,0,5.153,10.153,19.764,"W01000635"
"636","W01000636",12,1942,925,1017,481,1461,0,0.346,0,0.584,5.622,6.552,"W01000636"
"637","W01000637",14,1427,681,746,334,1093,0,0,0,0.831,5.334,6.165,"W01000637"
"638","W01000638",7,1193,586,607,338,855,0,0,0,0.139,2.323,2.462,"W01000638"
"639","W01000639",15,1361,661,700,269,1092,0,0,0,0.781,3.124,3.905,"W01000639"
"640","W01000640",21,1161,565,596,181,980,3.102,0,0,1.795,5.025,9.922,"W01000640"
"641","W01000641",132,2075,1038,1037,283,1792,2.411,0.572,0,2.179,7.316,12.478,"W01000641"
"642","W01000642",104,1725,805,920,279,1446,3.041,3.51,0,8.958,10.076,25.585,"W01000642"
"643","W01000643",9,1689,773,916,422,1267,0,0.445,0,0.565,3.511,4.521,"W01000643"
"644","W01000644",25,1857,820,1037,371,1486,0.181,0.12,0,6.076,9.408,15.785,"W01000644"
"645","W01000645",20,1697,770,927,383,1314,0,0,0,0.982,3.852,4.834,"W01000645"
"646","W01000646",75,2214,1072,1142,437,1777,6.93,3.648,0,35.796,61.496,107.87,"W01000646"
"647","W01000647",99,1518,743,775,296,1222,14.172,0,0,95.107,108.763,218.042,"W01000647"
"648","W01000648",67,1480,754,726,287,1193,6.021,11.238,0,76.109,49.598,142.966,"W01000648"
"649","W01000649",195,1538,762,776,262,1276,9.652,4.488,0,26.723,55.884,96.747,"W01000649"
"650","W01000650",86,1613,824,789,265,1348,13.844,15.139,0,156.331,103.504,288.818,"W01000650"
"651","W01000651",46,1588,767,821,343,1245,0.963,0.892,0,2.507,6.233,10.595,"W01000651"
"652","W01000652",11,2009,951,1058,499,1510,0,0.141,0,0.68,4.767,5.588,"W01000652"
"653","W01000653",47,1465,691,774,271,1194,0.348,0.598,0,1.632,3.905,6.483,"W01000653"
"654","W01000654",68,1738,878,860,349,1389,0.899,0.824,0,3.937,4.141,9.801,"W01000654"
"655","W01000655",52,2054,970,1084,532,1522,0.488,0.505,0,3.764,7.41,12.167,"W01000655"
"656","W01000656",36,2139,1032,1107,475,1664,1.688,0,0,3.56,12.092,17.34,"W01000656"
"657","W01000657",41,1078,511,567,197,881,1.407,0,0,9.079,6.016,16.502,"W01000657"
"658","W01000658",31,1269,639,630,286,983,0.724,0,0,1.769,5.195,7.688,"W01000658"
"659","W01000659",33,1542,729,813,395,1147,0,0.867,0,2.8,5.058,8.725,"W01000659"
"660","W01000660",18,1539,739,800,316,1223,0,0.102,0,1.775,4.201,6.078,"W01000660"
"661","W01000661",42,NA,NA,NA,NA,NA,NA,NA,NA,NA,NA,NA,NA
"662","W01000662",71,2155,1060,1095,427,1728,0,9.824,0,13.1,18.985,41.909,"W01000662"
"663","W01000663",27,2261,1062,1199,430,1831,0,2.247,0,3.232,13.236,18.715,"W01000663"
"664","W01000664",77,1805,887,918,358,1447,1.376,0.523,0,4.858,14.264,21.021,"W01000664"
"665","W01000665",175,1780,883,897,320,1460,5.226,6.436,1.013,5.093,13.623,31.391,"W01000665"
"666","W01000666",44,1446,707,739,309,1137,1.236,0.686,0.155,0.908,3.061,6.046,"W01000666"
"667","W01000667",51,1412,675,737,286,1126,0.311,1.229,0,2.584,5.507,9.631,"W01000667"
"668","W01000668",53,NA,NA,NA,NA,NA,NA,NA,NA,NA,NA,NA,NA
"669","W01000669",89,NA,NA,NA,NA,NA,NA,NA,NA,NA,NA,NA,NA
"670","W01000670",17,1619,779,840,342,1277,0,0.361,0,0.542,3.213,4.116,"W01000670"
"671","W01000671",48,1904,911,993,432,1472,3.626,1.075,0,7.277,16.11,28.088,"W01000671"
"672","W01000672",138,1629,799,830,307,1322,14.568,9.695,0,83.044,48.004,155.311,"W01000672"
"673","W01000673",29,1222,598,624,235,987,5.815,0,0,36.876,18.244,60.935,"W01000673"
"674","W01000674",84,2087,1080,1007,394,1693,6.643,0,0,75.145,116.968,198.756,"W01000674"
"675","W01000675",108,1963,960,1003,345,1618,4.399,18.555,0,22.023,54.414,99.391,"W01000675"
"676","W01000676",99,1532,757,775,279,1253,6.653,1.37,0,27.484,42.137,77.644,"W01000676"
"677","W01000677",36,1439,667,772,298,1141,1.56,0.052,0,2.121,3.923,7.656,"W01000677"
"678","W01000678",86,1421,702,719,237,1184,15.029,0,0,129.651,75.239,219.919,"W01000678"
"679","W01000679",34,1268,629,639,269,999,2.567,0.394,0,4.481,7.423,14.865,"W01000679"
"680","W01000680",23,2011,975,1036,395,1616,1.679,0.913,0,6.263,20.518,29.373,"W01000680"
"681","W01000681",38,1983,986,997,426,1557,3.486,0.658,0,5.223,11.273,20.64,"W01000681"
"682","W01000682",50,1381,655,726,298,1083,6.021,2.923,0,18.694,42.606,70.244,"W01000682"
"683","W01000683",27,1059,542,517,177,882,0,15.35,0,97.656,100.699,213.705,"W01000683"
"684","W01000684",157,1851,921,930,381,1470,12.23,9.675,0,24.788,57.701,104.394,"W01000684"
"685","W01000685",114,1589,801,788,326,1263,4.224,9.329,0,31.817,33.809,79.179,"W01000685"
"686","W01000686",91,1262,630,632,250,1012,8.613,3.872,0,42.771,42.659,97.915,"W01000686"
"687","W01000687",128,1929,971,958,363,1566,23.465,0,0,80.918,152.17,256.553,"W01000687"
"688","W01000688",46,1808,900,908,402,1406,5.72,3.57,0,13.893,22.077,45.26,"W01000688"
"689","W01000689",49,1619,778,841,293,1326,6.307,3.999,0,34.929,45.289,90.524,"W01000689"
"690","W01000690",49,1755,875,880,346,1409,1.923,0.765,0,5.21,9.08,16.978,"W01000690"
"691","W01000691",25,1591,772,819,303,1288,0,1.553,0,0.465,4.563,6.581,"W01000691"
"692","W01000692",24,1618,809,809,416,1202,0.009,0.521,0,1.539,4.293,6.362,"W01000692"
"693","W01000693",15,1079,490,589,206,873,0,0.34,0,0.224,3.895,4.459,"W01000693"
"694","W01000694",309,1302,649,653,221,1081,10.522,4.737,0,12.517,35.434,63.21,"W01000694"
"695","W01000695",27,1534,769,765,310,1224,0,2.291,0,6.694,14.304,23.289,"W01000695"
"696","W01000696",72,1568,790,778,302,1266,0,10.118,0,19.029,40.897,70.044,"W01000696"
"697","W01000697",122,1834,909,925,345,1489,3.026,0.356,0,2.915,9.798,16.095,"W01000697"
"698","W01000698",33,1906,906,1000,430,1476,0.959,1.531,0,1.01,6.431,9.931,"W01000698"
"699","W01000699",262,1530,773,757,295,1235,10.1,5.464,0,15.51,25.139,56.213,"W01000699"
"700","W01000700",65,2006,969,1037,334,1672,0,9.154,0,31.848,90.102,131.104,"W01000700"
"701","W01000701",73,1589,777,812,345,1244,11.719,7.694,0,62.694,55.753,137.86,"W01000701"
"702","W01000702",19,1218,604,614,263,955,2.411,1.599,0,3.214,6.687,13.911,"W01000702"
"703","W01000703",41,1863,896,967,439,1424,0.922,0,0,2.302,4.746,7.97,"W01000703"
"704","W01000704",32,1640,785,855,310,1330,0.989,0,0,1.153,3.915,6.057,"W01000704"
"705","W01000705",37,1954,937,1017,484,1470,0,0,0,2.457,5.361,7.818,"W01000705"
"706","W01000706",101,1649,811,838,396,1253,0.386,1.392,0,1.746,3.951,7.475,"W01000706"
"707","W01000707",19,1473,702,771,395,1078,0,0.366,0,0,3.492,3.858,"W01000707"
"708","W01000708",36,1384,693,691,356,1028,0,1.117,0,2.44,4.897,8.454,"W01000708"
"709","W01000709",116,2248,1118,1130,433,1815,7.555,14.603,0,42.686,90.242,155.086,"W01000709"
"710","W01000710",66,2271,1119,1152,497,1774,5.236,1.194,0,16.301,13.707,36.438,"W01000710"
"711","W01000711",33,2030,968,1062,412,1618,0.731,0.919,0,15.179,7.686,24.515,"W01000711"
"712","W01000712",14,1496,752,744,312,1184,0,1.959,0,1.402,5.833,9.194,"W01000712"
"713","W01000713",20,1393,704,689,309,1084,0,2.684,0,1.934,4.99,9.608,"W01000713"
"714","W01000714",17,1452,712,740,297,1155,0.656,0,0,1.078,3.917,5.651,"W01000714"
"715","W01000715",47,1297,640,657,266,1031,0.61,0,0,0.559,4.566,5.735,"W01000715"
"716","W01000716",40,1337,659,678,269,1068,0,5.846,0,7.838,7.558,21.242,"W01000716"
"717","W01000717",14,1431,705,726,280,1151,0,2.17,0,2.697,5.927,10.794,"W01000717"
"718","W01000718",17,1424,700,724,315,1109,1.167,0,0,0.614,4.544,6.325,"W01000718"
"719","W01000719",81,1497,741,756,313,1184,4.144,0,0,7.817,5.257,17.218,"W01000719"
"720","W01000720",93,1632,802,830,259,1373,6.728,1.147,0,11.666,12.734,32.275,"W01000720"
"721","W01000721",28,1363,639,724,306,1057,3.25,1.91,0,12.106,11.46,28.726,"W01000721"
"722","W01000722",130,1304,646,658,188,1116,9.104,4.31,0,19.559,40.838,73.811,"W01000722"
"723","W01000723",28,1370,681,689,241,1129,0,0,0,15.767,34.729,50.496,"W01000723"
"724","W01000724",49,1912,920,992,420,1492,0,1.642,0,3.77,9.51,14.922,"W01000724"
"725","W01000725",72,2199,1053,1146,394,1805,0.92,0.001,0,2.347,10.821,14.089,"W01000725"
"726","W01000726",41,1526,758,768,275,1251,3.163,0,0,4.281,11.614,19.058,"W01000726"
"727","W01000727",6,1010,480,530,154,856,0,0,0,0.045,2.422,2.467,"W01000727"
"728","W01000728",68,2072,1072,1000,368,1704,0,19.533,0,95.259,140.947,255.739,"W01000728"
"729","W01000729",20,1265,590,675,263,1002,0,0.842,0,2.255,3.155,6.252,"W01000729"
"730","W01000730",45,1276,636,640,265,1011,0,7.301,0,10.623,10.132,28.056,"W01000730"
"731","W01000731",94,2438,1231,1207,495,1943,3.313,1.935,0,8.41,12.648,26.306,"W01000731"
"732","W01000732",47,1390,690,700,251,1139,0,0.149,0,2.318,2.775,5.242,"W01000732"
"733","W01000733",64,1256,626,630,248,1008,0.518,0.268,0,1.532,3.756,6.074,"W01000733"
"734","W01000734",18,1433,745,688,371,1062,0,0,0,1.42,3.128,4.548,"W01000734"
"735","W01000735",53,2272,1115,1157,473,1799,2.964,2.874,0,15.017,28.155,49.01,"W01000735"
"736","W01000736",14,1715,822,893,307,1408,0,0.11,0,2.996,7.564,10.67,"W01000736"
"737","W01000737",23,1536,719,817,248,1288,0,1.471,0,2.174,5.446,9.091,"W01000737"
"738","W01000738",36,1768,851,917,448,1320,0,0,0,2.406,7.738,10.144,"W01000738"
"739","W01000739",55,1840,921,919,411,1429,0.76,1.632,0,0.955,3.785,7.132,"W01000739"
"740","W01000740",58,1658,773,885,270,1388,0.147,0,0,0.463,4.73,5.34,"W01000740"
"741","W01000741",74,1591,748,843,331,1260,0.128,0.67,0,2.463,6.887,10.148,"W01000741"
"742","W01000742",77,1581,827,754,323,1258,0.208,0.615,0,0.256,3.637,4.716,"W01000742"
"743","W01000743",419,NA,NA,NA,NA,NA,NA,NA,NA,NA,NA,NA,NA
"744","W01000744",88,1492,763,729,244,1248,0.887,0.135,0,0.102,3.12,4.244,"W01000744"
"745","W01000745",263,2259,1329,930,258,2001,0.881,0.412,0,1.104,4.754,7.151,"W01000745"
"746","W01000746",33,1705,923,782,155,1550,0,0,0,0.191,3.036,3.227,"W01000746"
"747","W01000747",73,1944,1135,809,215,1729,0.072,0.088,0,0.186,1.735,2.081,"W01000747"
"748","W01000748",157,NA,NA,NA,NA,NA,NA,NA,NA,NA,NA,NA,NA
"749","W01000749",95,1860,944,916,249,1611,0.153,0.442,0,0.577,2.4,3.572,"W01000749"
"750","W01000750",16,1552,727,825,315,1237,0,0,0,1.075,5.971,7.046,"W01000750"
"751","W01000751",28,1422,691,731,228,1194,0.056,1.008,0,2.478,6.251,9.793,"W01000751"
"752","W01000752",17,1518,727,791,395,1123,0,0.097,0,0.4,4.546,5.043,"W01000752"
"753","W01000753",13,1420,666,754,337,1083,0,0,0,0.199,4.013,4.212,"W01000753"
"754","W01000754",63,1591,778,813,353,1238,0.04,0.746,0,1.778,3.742,6.306,"W01000754"
"755","W01000755",84,1957,950,1007,432,1525,0.644,0,0,1.553,4.776,6.973,"W01000755"
"756","W01000756",70,1597,777,820,365,1232,0,0.548,0,1.701,5.042,7.291,"W01000756"
"757","W01000757",93,1492,685,807,227,1265,0.989,0.634,0,1.077,3.735,6.435,"W01000757"
"758","W01000758",67,1917,962,955,381,1536,0.699,0,0,0.75,4.356,5.805,"W01000758"
"759","W01000759",39,1566,753,813,256,1310,0,1.018,0,2.045,2.935,5.998,"W01000759"
"760","W01000760",63,1670,820,850,371,1299,0.079,0.56,0,2.306,6.437,9.382,"W01000760"
"761","W01000761",69,1569,784,785,382,1187,0.293,0,0,0.534,3.517,4.344,"W01000761"
"762","W01000762",50,1594,797,797,392,1202,0,0,0,0.221,3.757,3.978,"W01000762"
"763","W01000763",19,1524,723,801,377,1147,0,0,0,0,1.578,1.578,"W01000763"
"764","W01000764",97,1649,836,813,375,1274,1.063,0,0,2.076,4.365,7.504,"W01000764"
"765","W01000765",38,1660,839,821,332,1328,0,0.118,0,0.405,2.742,3.265,"W01000765"
"766","W01000766",28,1585,740,845,381,1204,0,0,0,0.881,2.909,3.79,"W01000766"
"767","W01000767",18,1554,763,791,280,1274,0,0,0,1.109,3.442,4.551,"W01000767"
"768","W01000768",20,1395,691,704,273,1122,0,0.754,0,0.807,2.914,4.475,"W01000768"
"769","W01000769",4,1412,666,746,297,1115,0,0,0,1.165,4.595,5.76,"W01000769"
"770","W01000770",26,1576,786,790,331,1245,0,0.363,0,0.15,2.828,3.341,"W01000770"
"771","W01000771",29,1331,659,672,270,1061,1.611,0,0,3.072,6.718,11.401,"W01000771"
"772","W01000772",30,1583,742,841,364,1219,0,0,0,2.477,11.998,14.475,"W01000772"
"773","W01000773",83,2663,1312,1351,658,2005,0.878,0.628,0,2.833,8.177,12.516,"W01000773"
"774","W01000774",67,1638,810,828,333,1305,0.617,0.226,0,2.095,3.187,6.125,"W01000774"
"775","W01000775",78,1843,905,938,366,1477,6.445,5.697,0,38.108,32.277,82.527,"W01000775"
"776","W01000776",125,1853,925,928,351,1502,5.285,10.468,0,29.781,40.909,86.443,"W01000776"
"777","W01000777",54,1782,844,938,339,1443,0,1.429,0,0.458,3.993,5.88,"W01000777"
"778","W01000778",48,1890,915,975,440,1450,0,0.532,0,1.474,3.81,5.816,"W01000778"
"779","W01000779",58,1540,759,781,388,1152,0,2.317,0,2.833,4.985,10.135,"W01000779"
"780","W01000780",10,NA,NA,NA,NA,NA,NA,NA,NA,NA,NA,NA,NA
"781","W01000781",20,1701,814,887,344,1357,0,0.008,0,0.359,3.658,4.025,"W01000781"
"782","W01000782",10,1080,514,566,162,918,0,0.284,0,0.18,2.395,2.859,"W01000782"
"783","W01000783",32,NA,NA,NA,NA,NA,NA,NA,NA,NA,NA,NA,NA
"784","W01000784",13,1317,617,700,258,1059,0,0.801,0,0.48,1.792,3.073,"W01000784"
"785","W01000785",27,1316,664,652,247,1069,0,0.38,0,0,3.678,4.058,"W01000785"
"786","W01000786",148,1375,662,713,243,1132,3.298,3.009,0,2.894,3.645,12.846,"W01000786"
"787","W01000787",63,1551,790,761,311,1240,0.152,0.048,0,1.843,4.942,6.985,"W01000787"
"788","W01000788",243,1456,722,734,307,1149,0.895,1.654,0,1.352,4.093,7.994,"W01000788"
"789","W01000789",18,1423,685,738,324,1099,0,0.506,0,0.275,2.096,2.877,"W01000789"
"790","W01000790",48,1738,883,855,391,1347,0.004,0.349,0,0.945,4.119,5.417,"W01000790"
"791","W01000791",19,1504,736,768,341,1163,0.326,0.197,0,0,3.268,3.791,"W01000791"
"792","W01000792",46,1645,795,850,334,1311,3.187,0,0,2.681,7.479,13.347,"W01000792"
"793","W01000793",116,1890,930,960,486,1404,2.357,2.048,3.71,12.294,8.461,28.87,"W01000793"
"794","W01000794",313,2176,1078,1098,513,1663,2.739,1.543,0,5.563,20.945,30.79,"W01000794"
"795","W01000795",62,1621,806,815,364,1257,0.9,0.409,0.351,2.493,3.459,7.612,"W01000795"
"796","W01000796",86,2723,1358,1365,716,2007,0,0,0.004,1.657,10.259,11.92,"W01000796"
"797","W01000797",34,1514,736,778,291,1223,0.444,0.884,0,0.254,3.385,4.967,"W01000797"
"798","W01000798",20,1416,681,735,235,1181,0,0,0,0.198,4.079,4.277,"W01000798"
"799","W01000799",31,1935,933,1002,575,1360,0,0,0,0.525,3.968,4.493,"W01000799"
"800","W01000800",46,1500,709,791,295,1205,0,2.259,0,1.496,4.201,7.956,"W01000800"
"801","W01000801",19,1548,747,801,394,1154,0,0.865,0,0.271,2.939,4.075,"W01000801"
"802","W01000802",44,2355,1148,1207,536,1819,0.729,0.071,0,0.571,5.853,7.224,"W01000802"
"803","W01000803",56,1850,954,896,358,1492,0,0,0,34.08,52.451,86.531,"W01000803"
"804","W01000804",61,1483,700,783,249,1234,0.662,1.147,0,2.782,3.944,8.535,"W01000804"
"805","W01000805",5,1193,573,620,244,949,0,0.056,0,0.379,3.778,4.213,"W01000805"
"806","W01000806",66,1515,730,785,321,1194,0.107,0.423,0.021,0.28,2.611,3.442,"W01000806"
"807","W01000807",14,1421,714,707,242,1179,0,0,0,0.243,4.017,4.26,"W01000807"
"808","W01000808",38,1465,701,764,238,1227,0,0,0,0.496,3.341,3.837,"W01000808"
"809","W01000809",49,1604,770,834,365,1239,1.352,0.612,0,0.392,2.342,4.698,"W01000809"
"810","W01000810",19,1376,644,732,342,1034,0,0,0,0.214,3.102,3.316,"W01000810"
"811","W01000811",31,1590,808,782,379,1211,0,0,0,0.248,3.791,4.039,"W01000811"
"812","W01000812",132,1434,711,723,284,1150,1.682,0.163,0,0.396,3.259,5.5,"W01000812"
"813","W01000813",49,1624,803,821,321,1303,0.25,0.16,0,1.061,3.01,4.481,"W01000813"
"814","W01000814",29,1565,777,788,371,1194,0,0.693,0,0.514,2.955,4.162,"W01000814"
"815","W01000815",136,1599,790,809,279,1320,0.782,1.241,0.68,4.255,4.755,11.713,"W01000815"
"816","W01000816",70,1735,852,883,394,1341,0,0,0,3.027,6.6,9.627,"W01000816"
"817","W01000817",30,1769,836,933,436,1333,0,0.527,0,2.32,4.238,7.085,"W01000817"
"818","W01000818",31,1536,725,811,339,1197,0,0,0,0.24,3.188,3.428,"W01000818"
"819","W01000819",12,1437,711,726,211,1226,0,0,0,0.266,3.909,4.175,"W01000819"
"820","W01000820",51,1395,691,704,251,1144,0,1.038,0,0.514,2.197,3.749,"W01000820"
"821","W01000821",47,1494,721,773,273,1221,0,0.406,0,0.648,3.898,4.952,"W01000821"
"822","W01000822",20,1241,616,625,162,1079,0.66,0,0,3.736,3.192,7.588,"W01000822"
"823","W01000823",3,1728,802,926,322,1406,0,0.001,0,0.589,5.109,5.699,"W01000823"
"824","W01000824",13,1588,748,840,243,1345,0,1.51,0,3.383,6.717,11.61,"W01000824"
"825","W01000825",65,1437,683,754,198,1239,0.213,0.674,0,0.884,2.684,4.455,"W01000825"
"826","W01000826",31,1365,649,716,211,1154,0,0.678,0,1.775,7.13,9.583,"W01000826"
"827","W01000827",31,1358,665,693,241,1117,0,0.669,0,1.195,3.266,5.13,"W01000827"
"828","W01000828",27,1722,851,871,307,1415,0,2.791,0,4.429,14.079,21.299,"W01000828"
"829","W01000829",24,1913,920,993,364,1549,0,1.998,0,0.717,6.474,9.189,"W01000829"
"830","W01000830",47,1693,794,899,589,1104,0,0,0,0.121,4.473,4.594,"W01000830"
"831","W01000831",48,1806,850,956,445,1361,0,0,0,0.338,3.793,4.131,"W01000831"
"832","W01000832",21,1604,820,784,377,1227,0,0,0,0.127,2.999,3.126,"W01000832"
"833","W01000833",31,1750,847,903,528,1222,0,0,0,0.592,2.789,3.381,"W01000833"
"834","W01000834",32,1545,709,836,457,1088,0,0,0,0.504,4.268,4.772,"W01000834"
"835","W01000835",13,1447,649,798,374,1073,0,0,0,0.332,3.494,3.826,"W01000835"
"836","W01000836",57,2274,1080,1194,664,1610,0.061,0.362,0,0.305,6.185,6.913,"W01000836"
"837","W01000837",219,1624,797,827,355,1269,3.922,0,0.838,3.329,7.437,15.526,"W01000837"
"838","W01000838",46,1244,589,655,286,958,1.289,0,0,1.101,5.709,8.099,"W01000838"
"839","W01000839",56,1011,497,514,192,819,2.987,0.868,0,4.062,4.631,12.548,"W01000839"
"840","W01000840",10,1677,829,848,308,1369,0,0,0,3.205,7.252,10.457,"W01000840"
"841","W01000841",9,1479,732,747,285,1194,0,0,0,0.165,3.354,3.519,"W01000841"
"842","W01000842",47,1424,686,738,261,1163,0,2.993,0,1.837,6.885,11.715,"W01000842"
"843","W01000843",4,1379,673,706,308,1071,0,0,0,0.36,2.88,3.24,"W01000843"
"844","W01000844",5,1241,619,622,305,936,0,0,0,1.42,3.935,5.355,"W01000844"
"845","W01000845",42,2048,972,1076,477,1571,1.672,0.727,0,1.867,5.735,10.001,"W01000845"
"846","W01000846",35,1730,847,883,387,1343,1.22,0,0,0.668,5.181,7.069,"W01000846"
"847","W01000847",25,1306,665,641,260,1046,0.05,0,0,4.403,5.967,10.42,"W01000847"
"848","W01000848",7,1197,568,629,301,896,0,0,0,0.097,2.569,2.666,"W01000848"
"849","W01000849",50,1872,911,961,471,1401,1.629,0,0,3.766,7.213,12.608,"W01000849"
"850","W01000850",188,2260,1217,1043,338,1922,1.313,0,0,6.32,4.406,12.039,"W01000850"
"851","W01000851",74,1544,752,792,314,1230,0.882,0.055,0,0.227,3.085,4.249,"W01000851"
"852","W01000852",24,1511,737,774,332,1179,0,0,0,1.105,2.883,3.988,"W01000852"
"853","W01000853",40,1470,737,733,303,1167,0.229,0,0,2.196,2.928,5.353,"W01000853"
"854","W01000854",10,1418,705,713,296,1122,0,0,0,1.745,4.765,6.51,"W01000854"
"855","W01000855",7,1517,733,784,258,1259,0.241,0,0,0.294,3.106,3.641,"W01000855"
"856","W01000856",24,1765,864,901,306,1459,0.077,0,0,0.404,3.583,4.064,"W01000856"
"857","W01000857",62,1785,836,949,293,1492,0.202,0,0,0.655,2.255,3.112,"W01000857"
"858","W01000858",72,1629,808,821,273,1356,0.605,0,0,0.857,3.171,4.633,"W01000858"
"859","W01000859",20,1415,667,748,175,1240,0,0.035,0,0.036,4.136,4.207,"W01000859"
"860","W01000860",110,1489,718,771,230,1259,0.976,1.634,0,2.734,5.138,10.482,"W01000860"
"861","W01000861",104,1813,867,946,125,1688,2.237,0.102,0,4.462,1.484,8.285,"W01000861"
"862","W01000862",48,1599,748,851,518,1081,0,0,0,0.176,2.099,2.275,"W01000862"
"863","W01000863",27,1586,773,813,443,1143,0,0,0,0.106,1.137,1.243,"W01000863"
"864","W01000864",68,1651,794,857,511,1140,0,0,0,0.12,3.43,3.55,"W01000864"
"865","W01000865",25,1352,623,729,312,1040,0,0,0,0.129,1.71,1.839,"W01000865"
"866","W01000866",12,1209,558,651,324,885,0,0,0,0.622,2.521,3.143,"W01000866"
"867","W01000867",24,1299,589,710,329,970,0,0,0,0.044,3.051,3.095,"W01000867"
"868","W01000868",34,1348,652,696,198,1150,0.183,0,0,0.512,3.76,4.455,"W01000868"
"869","W01000869",43,1590,840,750,186,1404,0.062,0,0,0.928,3.983,4.973,"W01000869"
"870","W01000870",27,1611,834,777,202,1409,0.187,0,0,1.056,1.859,3.102,"W01000870"
"871","W01000871",63,1765,991,774,145,1620,0.183,0,0,0.449,2.727,3.359,"W01000871"
"872","W01000872",23,1384,668,716,265,1119,0.278,0,0,0.221,3.423,3.922,"W01000872"
"873","W01000873",53,1809,985,824,95,1714,0.746,0,0,0.829,1.948,3.523,"W01000873"
"874","W01000874",56,2085,1094,991,194,1891,0.26,0,0,1.962,2.48,4.702,"W01000874"
"875","W01000875",66,2023,1131,892,117,1906,0.195,0.123,0,0.702,2.129,3.149,"W01000875"
"876","W01000876",4,2050,1106,944,156,1894,0,0,0,0.725,2.753,3.478,"W01000876"
"877","W01000877",46,1548,771,777,311,1237,0.469,0,0,0.916,3.085,4.47,"W01000877"
"878","W01000878",12,1223,587,636,249,974,0.587,0.419,0,0.44,2.436,3.882,"W01000878"
"879","W01000879",6,1758,839,919,326,1432,0,0,0,0.195,5.216,5.411,"W01000879"
"880","W01000880",35,1579,764,815,224,1355,0.829,0,0,0.854,4.213,5.896,"W01000880"
"881","W01000881",24,1382,661,721,223,1159,0.349,0,0,0.922,4.084,5.355,"W01000881"
"882","W01000882",11,1729,795,934,362,1367,0,0.002,0,0.332,4.741,5.075,"W01000882"
"883","W01000883",45,1404,706,698,202,1202,0.444,0,0,0.717,7.893,9.054,"W01000883"
"884","W01000884",70,1244,639,605,282,962,0.292,0.167,0.018,1.875,2.94,5.292,"W01000884"
"885","W01000885",96,1325,629,696,271,1054,0.074,0,0,3.142,4.885,8.101,"W01000885"
"886","W01000886",102,1479,754,725,308,1171,0.54,0,0,2.768,4.115,7.423,"W01000886"
"887","W01000887",86,2400,1182,1218,585,1815,3.963,1.584,0,4.474,8.584,18.605,"W01000887"
"888","W01000888",72,2327,1151,1176,496,1831,0.791,0,0,4.532,12.169,17.492,"W01000888"
"889","W01000889",109,1789,874,915,305,1484,2.656,0,2.453,1.17,5.24,11.519,"W01000889"
"890","W01000890",3,1656,806,850,313,1343,0,0,0,0.217,4.948,5.165,"W01000890"
"891","W01000891",37,1515,724,791,309,1206,0.102,0,0,0.771,3.99,4.863,"W01000891"
"892","W01000892",96,1859,901,958,314,1545,0.998,0,0,22.41,8.845,32.253,"W01000892"
"893","W01000893",24,1989,978,1011,411,1578,0.283,0.177,0,7.506,7.74,15.706,"W01000893"
"894","W01000894",36,1370,653,717,244,1126,0.656,0,0,2.422,4.884,7.962,"W01000894"
"895","W01000895",117,1539,772,767,286,1253,1.233,0,0,2.429,4.081,7.743,"W01000895"
"896","W01000896",2,1686,781,905,452,1234,0,0,0,1.652,3.4,5.052,"W01000896"
"897","W01000897",57,1316,643,673,262,1054,0,0,0,2.717,8.087,10.804,"W01000897"
"898","W01000898",51,1470,738,732,312,1158,0.766,5.351,0,11.723,8.555,26.395,"W01000898"
"899","W01000899",26,1679,811,868,364,1315,0,0.774,0,0.926,5.229,6.929,"W01000899"
"900","W01000900",58,1709,835,874,332,1377,0.278,1.334,0,1.145,5.489,8.246,"W01000900"
"901","W01000901",11,1680,802,878,347,1333,0,0.103,0,1.482,5.335,6.92,"W01000901"
"902","W01000902",13,1060,503,557,172,888,1.28,0,0,1.617,5.575,8.472,"W01000902"
"903","W01000903",9,1116,528,588,172,944,0.642,0,0,0.247,3.015,3.904,"W01000903"
"904","W01000904",4,1529,753,776,347,1182,0,0,0,0.3,4.827,5.127,"W01000904"
"905","W01000905",7,1563,754,809,384,1179,0.181,0,0,0.472,3.074,3.727,"W01000905"
"906","W01000906",128,1047,503,544,136,911,1.155,0,0,1.747,3.97,6.872,"W01000906"
"907","W01000907",15,1752,840,912,421,1331,0.097,0,0,0.754,3.832,4.683,"W01000907"
"908","W01000908",25,1684,835,849,307,1377,1.937,0,0,2.501,6.415,10.853,"W01000908"
"909","W01000909",20,1216,556,660,206,1010,0,0.545,0,0.526,2.337,3.408,"W01000909"
"910","W01000910",11,1470,712,758,241,1229,0,0.745,0,0.129,3.545,4.419,"W01000910"
"911","W01000911",5,1254,623,631,245,1009,0,0.162,0,0.204,1.955,2.321,"W01000911"
"912","W01000912",44,1229,566,663,211,1018,0.198,0.346,0,1.027,2.414,3.985,"W01000912"
"913","W01000913",32,1162,562,600,210,952,0.275,0.06,0,0.63,1.837,2.802,"W01000913"
"914","W01000914",54,1599,759,840,361,1238,0,0.543,0,0.266,4.008,4.817,"W01000914"
"915","W01000915",6,1205,589,616,256,949,0,0,0,0.676,3.277,3.953,"W01000915"
"916","W01000916",46,1206,620,586,254,952,1.218,0,0,1.148,3.062,5.428,"W01000916"
"917","W01000917",446,2652,1308,1344,547,2105,5.236,4.056,6.413,20.93,22.983,59.618,"W01000917"
"918","W01000918",54,1910,925,985,362,1548,5.299,0,0,7.906,11.742,24.947,"W01000918"
"919","W01000919",18,1172,579,593,236,936,0.967,0,0,7.473,9.381,17.821,"W01000919"
"920","W01000920",63,1256,644,612,270,986,4.295,0,0,12.208,7.091,23.594,"W01000920"
"921","W01000921",36,1569,763,806,365,1204,1.134,0,0,1.021,5.313,7.468,"W01000921"
"922","W01000922",218,1690,826,864,366,1324,2.712,0.35,0,1.928,5.109,10.099,"W01000922"
"923","W01000923",45,1472,734,738,240,1232,0.403,0,0,1.973,6.081,8.457,"W01000923"
"924","W01000924",11,1096,548,548,217,879,0,0,0,12.982,6.626,19.608,"W01000924"
"925","W01000925",43,1571,773,798,356,1215,0,4.775,0,16.048,5.188,26.011,"W01000925"
"926","W01000926",60,1859,921,938,303,1556,4.421,2.517,0,6.617,7.118,20.673,"W01000926"
"927","W01000927",56,1644,785,859,352,1292,2.917,0.093,0,1.832,7.601,12.443,"W01000927"
"928","W01000928",45,1603,784,819,305,1298,1.467,0,0,0.296,7.915,9.678,"W01000928"
"929","W01000929",20,1307,671,636,300,1007,1.762,0,0,1.914,4.09,7.766,"W01000929"
"930","W01000930",19,1362,671,691,297,1065,5.522,0,0,12.505,6.539,24.566,"W01000930"
"931","W01000931",14,1330,663,667,291,1039,1.069,0,0,3.138,5.778,9.985,"W01000931"
"932","W01000932",37,1043,526,517,164,879,3.979,0,0,32.536,7.403,43.918,"W01000932"
"933","W01000933",211,1974,953,1021,511,1463,6.671,2.773,3.482,43.877,21.541,78.344,"W01000933"
"934","W01000934",29,1263,627,636,227,1036,0,0,0,0.247,2.096,2.343,"W01000934"
"935","W01000935",90,1580,810,770,220,1360,0.372,0.395,0,1.053,2.178,3.998,"W01000935"
"936","W01000936",9,1518,743,775,374,1144,0,0,0,1.698,2.804,4.502,"W01000936"
"937","W01000937",81,2040,1033,1007,409,1631,1.228,0,0,2.419,5.89,9.537,"W01000937"
"938","W01000938",15,1396,660,736,199,1197,0,0.367,0,1.248,2.999,4.614,"W01000938"
"939","W01000939",112,1262,642,620,171,1091,0,1.633,0,1.233,5.264,8.13,"W01000939"
"940","W01000940",4,1284,608,676,277,1007,0,0.506,0,1.409,2.943,4.858,"W01000940"
"941","W01000941",11,1541,756,785,381,1160,0,0,0,1.626,3.718,5.344,"W01000941"
"942","W01000942",19,1887,925,962,472,1415,0,0.215,0,0,3.445,3.66,"W01000942"
"943","W01000943",15,1547,772,775,339,1208,0,0.831,0,0.375,3.288,4.494,"W01000943"
"944","W01000944",27,1194,601,593,229,965,6.629,0,0,12.556,5.989,25.174,"W01000944"
"945","W01000945",16,1152,577,575,226,926,0,2.607,0,4.127,12.185,18.919,"W01000945"
"946","W01000946",66,1604,778,826,335,1269,4.239,1.942,0,8.27,27.012,41.463,"W01000946"
"947","W01000947",22,2033,984,1049,494,1539,0.985,0,0,0.142,4.846,5.973,"W01000947"
"948","W01000948",84,1784,911,873,309,1475,0.997,0.942,0,1.512,6.723,10.174,"W01000948"
"949","W01000949",41,1337,670,667,226,1111,1.686,0.203,0,2.183,4.494,8.566,"W01000949"
"950","W01000950",56,1550,772,778,308,1242,0,0.096,0,2.754,3.356,6.206,"W01000950"
"951","W01000951",91,1583,804,779,318,1265,0.596,0,0.106,1.978,5.74,8.42,"W01000951"
"952","W01000952",44,1171,555,616,240,931,0.715,0,0.293,1.415,2.068,4.491,"W01000952"
"953","W01000953",35,1720,855,865,347,1373,0,4.763,0,21.185,3.436,29.384,"W01000953"
"954","W01000954",26,1415,697,718,256,1159,0.387,1.494,0,9.671,4.699,16.251,"W01000954"
"955","W01000955",27,1262,619,643,255,1007,1.468,0,0,6.162,7.739,15.369,"W01000955"
"956","W01000956",14,1180,574,606,179,1001,1.083,0,0,0.174,3.433,4.69,"W01000956"
"957","W01000957",32,1676,777,899,245,1431,0,0,0,0.418,6.519,6.937,"W01000957"
"958","W01000958",25,1679,777,902,398,1281,0,0,0,0.107,3.667,3.774,"W01000958"
"959","W01000959",20,1818,913,905,377,1441,0,0,0,1.066,4.038,5.104,"W01000959"
"960","W01000960",45,1722,839,883,342,1380,0.375,0,0,1.43,3.129,4.934,"W01000960"
"961","W01000961",34,1611,781,830,313,1298,0.024,0,0,0.258,3.823,4.105,"W01000961"
"962","W01000962",13,1577,757,820,414,1163,0.106,0,0,0.047,3.278,3.431,"W01000962"
"963","W01000963",19,1792,821,971,420,1372,0,0,0,0.582,5.433,6.015,"W01000963"
"964","W01000964",14,1745,832,913,364,1381,0,0,0,0.152,5.119,5.271,"W01000964"
"965","W01000965",30,2123,1052,1071,448,1675,3.267,0,0,5.476,6.107,14.85,"W01000965"
"966","W01000966",45,1432,738,694,238,1194,0,0,0,3.391,5.626,9.017,"W01000966"
"967","W01000967",57,1470,713,757,298,1172,1.158,0,0,1.624,3.77,6.552,"W01000967"
"968","W01000968",13,1897,925,972,388,1509,0.498,0,0,0.619,4.316,5.433,"W01000968"
"969","W01000969",10,1260,620,640,232,1028,0,1.522,0,2.565,5.972,10.059,"W01000969"
"970","W01000970",28,1239,592,647,229,1010,0,1.031,0,0.967,2.769,4.767,"W01000970"
"971","W01000971",24,1411,683,728,295,1116,0,1.343,0,1.695,5.422,8.46,"W01000971"
"972","W01000972",24,NA,NA,NA,NA,NA,NA,NA,NA,NA,NA,NA,NA
"973","W01000973",15,1480,731,749,292,1188,0.113,0.994,0,0.198,3.876,5.181,"W01000973"
"974","W01000974",141,2039,1022,1017,379,1660,3.572,1.207,0,8.084,13.178,26.041,"W01000974"
"975","W01000975",42,2253,1096,1157,594,1659,0,0,0,2.724,10.473,13.197,"W01000975"
"976","W01000976",24,1105,526,579,251,854,2.938,0.931,0,10.297,5.784,19.95,"W01000976"
"977","W01000977",74,1388,694,694,297,1091,3.619,0,0,2.664,5.364,11.647,"W01000977"
"978","W01000978",16,1789,888,901,403,1386,0.791,0,0,2.706,4.829,8.326,"W01000978"
"979","W01000979",24,1702,829,873,440,1262,0,0,0,0,2.66,2.66,"W01000979"
"980","W01000980",10,1383,699,684,293,1090,0,0,0,0.044,2.681,2.725,"W01000980"
"981","W01000981",12,1186,537,649,359,827,0,0,0,0.116,2.87,2.986,"W01000981"
"982","W01000982",32,1500,731,769,251,1249,0,0.491,0,0.272,4.727,5.49,"W01000982"
"983","W01000983",21,1539,776,763,367,1172,0,0.295,0,0,4.844,5.139,"W01000983"
"984","W01000984",6,2157,1076,1081,492,1665,0,0.022,0,0.034,4.216,4.272,"W01000984"
"985","W01000985",19,1399,684,715,344,1055,0,0,0,0,4.495,4.495,"W01000985"
"986","W01000986",78,1319,639,680,291,1028,3.003,2.508,0,3.096,9.818,18.425,"W01000986"
"987","W01000987",134,2252,1102,1150,533,1719,0.706,0,0.449,1.104,5.996,8.255,"W01000987"
"988","W01000988",10,NA,NA,NA,NA,NA,NA,NA,NA,NA,NA,NA,NA
"989","W01000989",177,1413,681,732,257,1156,8.846,0,0,8.279,23.897,41.022,"W01000989"
"990","W01000990",13,1519,735,784,330,1189,0.295,0,0,0.136,3.608,4.039,"W01000990"
"991","W01000991",26,1131,556,575,274,857,0.539,0,0,0.162,3.441,4.142,"W01000991"
"992","W01000992",10,1505,736,769,349,1156,0.215,0,0,3.293,3.188,6.696,"W01000992"
"993","W01000993",13,1525,764,761,378,1147,0,0,0,2.341,3.326,5.667,"W01000993"
"994","W01000994",22,1398,698,700,344,1054,0.732,0,0,2.864,2.999,6.595,"W01000994"
"995","W01000995",39,1436,685,751,274,1162,0.67,0,0,1.488,4.946,7.104,"W01000995"
"996","W01000996",56,1481,713,768,260,1221,0,2.77,0,2.31,8.172,13.252,"W01000996"
"997","W01000997",15,1537,743,794,250,1287,0,0,0,0,4.526,4.526,"W01000997"
"998","W01000998",58,2593,1963,630,280,2313,0,0,0,3.916,20.811,24.727,"W01000998"
"999","W01000999",34,1385,653,732,281,1104,0,0.524,0,0.314,4.228,5.066,"W01000999"
"1000","W01001000",181,1776,854,922,354,1422,4.669,0.673,2.765,4.541,11.125,23.773,"W01001000"
"1001","W01001001",19,1449,696,753,311,1138,0.201,0,0.192,0.499,5.469,6.361,"W01001001"
"1002","W01001002",16,2449,1209,1240,649,1800,0,0.301,0,0.413,6.22,6.934,"W01001002"
"1003","W01001003",111,1365,635,730,178,1187,5.821,0.373,0,6.831,27.32,40.345,"W01001003"
"1004","W01001004",65,1086,552,534,200,886,1.119,0,0,0.612,3.497,5.228,"W01001004"
"1005","W01001005",116,1688,834,854,316,1372,2.186,0,0.852,0.76,7.152,10.95,"W01001005"
"1006","W01001006",2,2377,1179,1198,478,1899,0,0,0,0.301,6.92,7.221,"W01001006"
"1007","W01001007",46,1748,885,863,411,1337,0,0,0,0.651,6.398,7.049,"W01001007"
"1008","W01001008",72,2147,1056,1091,366,1781,1.634,0,0,0.534,8.158,10.326,"W01001008"
"1009","W01001009",83,1243,642,601,262,981,5.231,0,0,5.306,13.065,23.602,"W01001009"
"1010","W01001010",7,1219,577,642,295,924,0,0,0,0.101,2.494,2.595,"W01001010"
"1011","W01001011",14,1384,694,690,300,1084,0,0,0,0.22,2.962,3.182,"W01001011"
"1012","W01001012",64,1563,791,772,379,1184,1.66,0.267,0,6.744,13.09,21.761,"W01001012"
"1013","W01001013",39,1469,709,760,262,1207,0.709,0.001,0,1.37,3.325,5.405,"W01001013"
"1014","W01001014",62,1640,801,839,309,1331,0.771,0.602,0,1.568,3.203,6.144,"W01001014"
"1015","W01001015",10,1475,699,776,359,1116,0,0,0,4.843,5.995,10.838,"W01001015"
"1016","W01001016",19,1658,817,841,262,1396,0,1.083,0,1.087,4.672,6.842,"W01001016"
"1017","W01001017",36,1477,707,770,317,1160,0,0.757,0,2.656,4.345,7.758,"W01001017"
"1018","W01001018",29,1387,696,691,260,1127,0.126,0,0,0.514,2.532,3.172,"W01001018"
"1019","W01001019",13,1512,751,761,331,1181,0,0,0,5.215,8.254,13.469,"W01001019"
"1020","W01001020",22,1436,715,721,324,1112,0.967,0,0,0.502,3.132,4.601,"W01001020"
"1021","W01001021",109,1603,810,793,294,1309,0.218,0.485,0,1.226,6.2,8.129,"W01001021"
"1022","W01001022",13,1393,683,710,343,1050,0,0,0,0,3.024,3.024,"W01001022"
"1023","W01001023",34,1696,851,845,281,1415,0,0,0,0.776,4.937,5.713,"W01001023"
"1024","W01001024",29,1144,568,576,236,908,6.333,0,0,1.551,3.918,11.802,"W01001024"
"1025","W01001025",12,1200,568,632,239,961,0.86,0,0,2.977,2.48,6.317,"W01001025"
"1026","W01001026",23,1995,977,1018,424,1571,0,0,0,0.462,6.34,6.802,"W01001026"
"1027","W01001027",20,1571,733,838,274,1297,0.44,0,0,0.049,3.856,4.345,"W01001027"
"1028","W01001028",119,1855,904,951,308,1547,1.972,0,0,1.763,5.501,9.236,"W01001028"
"1029","W01001029",32,1799,872,927,263,1536,1.082,0,0,4.347,6.211,11.64,"W01001029"
"1030","W01001030",27,1809,860,949,332,1477,0.128,0,0,4.905,7.564,12.597,"W01001030"
"1031","W01001031",6,1524,695,829,232,1292,0,0,0,0.676,5.004,5.68,"W01001031"
"1032","W01001032",68,1769,831,938,319,1450,2.197,0,0,0.805,7.741,10.743,"W01001032"
"1033","W01001033",33,1738,837,901,405,1333,1.395,0,0,7.836,4.459,13.69,"W01001033"
"1034","W01001034",16,1379,679,700,252,1127,0.967,0,0,1.821,5.196,7.984,"W01001034"
"1035","W01001035",87,1622,835,787,320,1302,0.174,0.73,0,1.48,3.705,6.089,"W01001035"
"1036","W01001036",36,1584,759,825,279,1305,0,0.239,0,1.2,3.994,5.433,"W01001036"
"1037","W01001037",151,1593,764,829,270,1323,1.938,1.416,0,1.795,8.021,13.17,"W01001037"
"1038","W01001038",43,2221,1047,1174,486,1735,0.883,0,0,1.205,6.791,8.879,"W01001038"
"1039","W01001039",25,1664,841,823,350,1314,0,1.47,0,1.344,4.865,7.679,"W01001039"
"1040","W01001040",22,1491,759,732,315,1176,0.1,0.947,0,7.668,17.903,26.618,"W01001040"
"1041","W01001041",65,2447,1210,1237,479,1968,1.599,0,0,3.71,11.446,16.755,"W01001041"
"1042","W01001042",35,1338,676,662,321,1017,0.813,0,0,2.073,2.599,5.485,"W01001042"
"1043","W01001043",13,1161,567,594,237,924,0.727,0,0,2.005,1.878,4.61,"W01001043"
"1044","W01001044",50,1663,811,852,323,1340,1.007,0,0,0.238,5.341,6.586,"W01001044"
"1045","W01001045",23,1725,826,899,338,1387,0.094,0,0,3.164,5.843,9.101,"W01001045"
"1046","W01001046",38,1775,848,927,277,1498,0.088,0,0,1.913,5.879,7.88,"W01001046"
"1047","W01001047",17,1674,816,858,320,1354,0,0,0,0.621,5.3,5.921,"W01001047"
"1048","W01001048",18,1401,700,701,259,1142,0,0.32,0,0.914,4.569,5.803,"W01001048"
"1049","W01001049",26,1315,640,675,300,1015,0.198,0,0,0.083,3.387,3.668,"W01001049"
"1050","W01001050",52,1539,759,780,291,1248,0.212,0.821,0,1.337,5.969,8.339,"W01001050"
"1051","W01001051",23,1796,920,876,458,1338,0,0.006,0,1.369,4.104,5.479,"W01001051"
"1052","W01001052",12,1354,646,708,277,1077,0.206,0.011,0,0.7,4.056,4.973,"W01001052"
"1053","W01001053",4,1010,499,511,145,865,0,0,0,0,3.343,3.343,"W01001053"
"1054","W01001054",12,1257,572,685,186,1071,0,0,0,0.132,7.159,7.291,"W01001054"
"1055","W01001055",42,1225,609,616,281,944,0.091,0,0,0.277,2.904,3.272,"W01001055"
"1056","W01001056",140,1218,609,609,198,1020,1.369,0.129,1.383,1.217,6.105,10.203,"W01001056"
"1057","W01001057",42,1435,703,732,272,1163,1.713,0,0,0.719,5.221,7.653,"W01001057"
"1058","W01001058",50,1932,929,1003,431,1501,0.967,0,0,0.723,4.501,6.191,"W01001058"
"1059","W01001059",27,1320,659,661,222,1098,0.745,0,0,1.054,4.922,6.721,"W01001059"
"1060","W01001060",5,1436,668,768,229,1207,0,0,0,0.566,4.804,5.37,"W01001060"
"1061","W01001061",45,2144,1025,1119,492,1652,1.414,0,0,5.131,8.411,14.956,"W01001061"
"1062","W01001062",56,1381,669,712,319,1062,0.477,0,0,1.71,2.671,4.858,"W01001062"
"1063","W01001063",41,1742,863,879,428,1314,0.121,0,0,2.135,2.144,4.4,"W01001063"
"1064","W01001064",21,1445,658,787,320,1125,0.353,0,0,0.495,3.284,4.132,"W01001064"
"1065","W01001065",36,1595,767,828,432,1163,0.55,0.473,0,2.132,2.556,5.711,"W01001065"
"1066","W01001066",54,1575,751,824,389,1186,0.626,0,0,0.657,3.482,4.765,"W01001066"
"1067","W01001067",21,1380,633,747,279,1101,0,0,0,0.118,3.075,3.193,"W01001067"
"1068","W01001068",61,1767,833,934,461,1306,0.954,0,0,0.002,4.683,5.639,"W01001068"
"1069","W01001069",35,1459,733,726,339,1120,0,0,0,0.984,4.004,4.988,"W01001069"
"1070","W01001070",18,1143,600,543,280,863,0.113,0,0,0.383,2.02,2.516,"W01001070"
"1071","W01001071",88,1577,787,790,360,1217,1.102,0,0,2.644,4.317,8.063,"W01001071"
"1072","W01001072",33,2676,1358,1318,680,1996,0.733,0,0,1.146,5.671,7.55,"W01001072"
"1073","W01001073",46,2001,1001,1000,410,1591,0,0,0,4.139,11.559,15.698,"W01001073"
"1074","W01001074",66,NA,NA,NA,NA,NA,NA,NA,NA,NA,NA,NA,NA
"1075","W01001075",1,1197,557,640,275,922,0,0,0,0.222,2.239,2.461,"W01001075"
"1076","W01001076",58,1461,696,765,348,1113,0.967,0,0,0.503,2.209,3.679,"W01001076"
"1077","W01001077",67,1432,664,768,264,1168,0.258,0.986,0,0.196,3.341,4.781,"W01001077"
"1078","W01001078",3,1263,605,658,286,977,0,0.149,0,0.001,2.384,2.534,"W01001078"
"1079","W01001079",28,1615,745,870,431,1184,0.084,0,0,1.974,2.193,4.251,"W01001079"
"1080","W01001080",52,1581,763,818,385,1196,0.24,0,0,0.797,3.82,4.857,"W01001080"
"1081","W01001081",22,1552,715,837,403,1149,0,0,0,1.031,3.731,4.762,"W01001081"
"1082","W01001082",32,1500,715,785,215,1285,1.314,0.167,0,0.445,4.317,6.243,"W01001082"
"1083","W01001083",25,1611,796,815,287,1324,0,1.152,0,5.117,21.826,28.095,"W01001083"
"1084","W01001084",53,1563,728,835,265,1298,5.028,0,0,4.657,13.322,23.007,"W01001084"
"1085","W01001085",63,1506,765,741,335,1171,3.545,0,0,9.982,35.358,48.885,"W01001085"
"1086","W01001086",58,1491,726,765,265,1226,0.752,0,0,2.081,13.471,16.304,"W01001086"
"1087","W01001087",49,1543,746,797,290,1253,0.456,0,0,0.65,2.731,3.837,"W01001087"
"1088","W01001088",8,1827,848,979,371,1456,0,0,0,0.342,4.763,5.105,"W01001088"
"1089","W01001089",66,1468,694,774,252,1216,2.502,0.412,0,2.372,5.416,10.702,"W01001089"
"1090","W01001090",71,1470,708,762,281,1189,0.148,1.884,0,4.815,10.001,16.848,"W01001090"
"1091","W01001091",31,1662,820,842,257,1405,0.64,0,0,0.661,5.862,7.163,"W01001091"
"1092","W01001092",37,1706,813,893,419,1287,0.694,0,0,2.625,4.04,7.359,"W01001092"
"1093","W01001093",42,1798,850,948,373,1425,0.362,0,0,1.972,4.092,6.426,"W01001093"
"1094","W01001094",8,1333,592,741,380,953,0,0,0,0,1.956,1.956,"W01001094"
"1095","W01001095",21,1509,696,813,445,1064,0,0,0,0,3.106,3.106,"W01001095"
"1096","W01001096",14,1374,667,707,250,1124,0,0,0,0.207,3.501,3.708,"W01001096"
"1097","W01001097",41,1679,801,878,511,1168,0.995,0,0,0.424,4.51,5.929,"W01001097"
"1098","W01001098",30,1071,501,570,165,906,0.526,0.295,0,0.277,1.393,2.491,"W01001098"
"1099","W01001099",10,1341,644,697,321,1020,0.007,0.06,0,0.15,2.206,2.423,"W01001099"
"1100","W01001100",11,1500,722,778,283,1217,0,0.58,0,0.086,3.427,4.093,"W01001100"
"1101","W01001101",28,1500,763,737,360,1140,0.344,0.063,0,1.599,1.528,3.534,"W01001101"
"1102","W01001102",26,1545,725,820,393,1152,0.312,0,0,1.679,2.11,4.101,"W01001102"
"1103","W01001103",31,1244,580,664,246,998,0.256,0,0,0.292,2.991,3.539,"W01001103"
"1104","W01001104",102,1977,968,1009,356,1621,1.039,0.999,0,2.665,6.18,10.883,"W01001104"
"1105","W01001105",169,2643,1313,1330,573,2070,3.549,9.125,0,16.227,64.048,92.949,"W01001105"
"1106","W01001106",8,1423,693,730,251,1172,0,0.024,0,0.06,4.473,4.557,"W01001106"
"1107","W01001107",33,1547,728,819,225,1322,0,0,0,0.66,7.417,8.077,"W01001107"
"1108","W01001108",36,1685,866,819,386,1299,0,0.53,0,8.36,17.451,26.341,"W01001108"
"1109","W01001109",7,1473,701,772,304,1169,0,0,0,1.714,3.332,5.046,"W01001109"
"1110","W01001110",54,1570,743,827,422,1148,0,5.34,0,6.02,31.165,42.525,"W01001110"
"1111","W01001111",4,1482,695,787,343,1139,0,0,0,0.434,2.206,2.64,"W01001111"
"1112","W01001112",14,1441,705,736,365,1076,0,0.762,0,0,3.208,3.97,"W01001112"
"1113","W01001113",281,2289,1147,1142,537,1752,2.946,0,3.703,27.82,58.106,92.575,"W01001113"
"1114","W01001114",42,1565,762,803,307,1258,0,0.604,0,0.095,6.27,6.969,"W01001114"
"1115","W01001115",13,2170,1023,1147,533,1637,0,0.515,0,0.126,5.551,6.192,"W01001115"
"1116","W01001116",22,2101,969,1132,379,1722,0,0,0,1.52,5.013,6.533,"W01001116"
"1117","W01001117",20,1416,699,717,269,1147,0,0,0,3.814,4.646,8.46,"W01001117"
"1118","W01001118",30,2380,1167,1213,570,1810,0.05,1.325,0,2.94,10.315,14.63,"W01001118"
"1119","W01001119",139,1731,848,883,410,1321,4.758,0.703,0,9.751,44.535,59.747,"W01001119"
"1120","W01001120",49,1380,677,703,257,1123,0,1.158,0,1.717,7.111,9.986,"W01001120"
"1121","W01001121",46,1545,781,764,334,1211,0,2.252,0,10.699,10.241,23.192,"W01001121"
"1122","W01001122",26,2950,1793,1157,774,2176,0,0.365,0,7.424,11.087,18.876,"W01001122"
"1123","W01001123",12,1633,798,835,247,1386,0,0,0,0.907,2.778,3.685,"W01001123"
"1124","W01001124",42,1463,745,718,291,1172,0.209,0,0,0.236,2.928,3.373,"W01001124"
"1125","W01001125",43,1471,720,751,328,1143,0.599,0,0,1.256,3.28,5.135,"W01001125"
"1126","W01001126",15,1911,1009,902,252,1659,0,0,0,0.302,5.722,6.024,"W01001126"
"1127","W01001127",60,1199,586,613,203,996,0,9.528,0,9.165,13.188,31.881,"W01001127"
"1128","W01001128",29,1439,714,725,263,1176,0,3.585,0,2.869,15.424,21.878,"W01001128"
"1129","W01001129",22,1384,671,713,361,1023,0,0.137,0,0.408,2.865,3.41,"W01001129"
"1130","W01001130",22,1279,627,652,296,983,0,0,0,1.254,3.029,4.283,"W01001130"
"1131","W01001131",10,1753,814,939,419,1334,0,0.205,0,0.7,2.528,3.433,"W01001131"
"1132","W01001132",9,1370,650,720,305,1065,0,0,0,0.026,2.942,2.968,"W01001132"
"1133","W01001133",84,2029,1014,1015,321,1708,0.377,2.18,0,5.264,7.827,15.648,"W01001133"
"1134","W01001134",22,1144,536,608,209,935,0,0.821,0,3.674,5.838,10.333,"W01001134"
"1135","W01001135",124,1494,721,773,307,1187,9.842,0,0,12.258,19.71,41.81,"W01001135"
"1136","W01001136",79,1165,556,609,185,980,2.041,0,0,1.723,6.888,10.652,"W01001136"
"1137","W01001137",62,2389,1152,1237,497,1892,0,0.907,0,1.877,5.473,8.257,"W01001137"
"1138","W01001138",59,1362,656,706,316,1046,0,0.747,0,0.546,2.483,3.776,"W01001138"
"1139","W01001139",17,1473,738,735,339,1134,0,0,0,1.758,2.797,4.555,"W01001139"
"1140","W01001140",18,1432,714,718,306,1126,0,0,0,1.892,5.046,6.938,"W01001140"
"1141","W01001141",12,1617,791,826,378,1239,0,0,0,4.552,4.227,8.779,"W01001141"
"1142","W01001142",123,1592,794,798,377,1215,0.123,2.504,0,3.855,6.876,13.358,"W01001142"
"1143","W01001143",54,1600,789,811,350,1250,0.872,0.45,0,3.664,6.963,11.949,"W01001143"
"1144","W01001144",52,1606,781,825,413,1193,0,1.806,0,1.001,4.062,6.869,"W01001144"
"1145","W01001145",69,1765,883,882,404,1361,0.705,1.811,0,0.372,3.671,6.559,"W01001145"
"1146","W01001146",170,1419,693,726,276,1143,1.251,0.478,0,2.091,4.888,8.708,"W01001146"
"1147","W01001147",23,1801,852,949,328,1473,0.048,0,0,6.862,6.998,13.908,"W01001147"
"1148","W01001148",99,1662,810,852,378,1284,0.581,0.437,0,1.109,4.334,6.461,"W01001148"
"1149","W01001149",27,1428,692,736,294,1134,1.023,0,0,1.116,2.887,5.026,"W01001149"
"1150","W01001150",122,1670,780,890,316,1354,1.057,0.53,0,0.27,4.707,6.564,"W01001150"
"1151","W01001151",33,1679,820,859,300,1379,0,0.006,0,1.082,5.728,6.816,"W01001151"
"1152","W01001152",123,1584,779,805,328,1256,0.045,4.644,0,7.611,12.342,24.642,"W01001152"
"1153","W01001153",56,1499,732,767,337,1162,0.094,1.274,0,0.365,4.023,5.756,"W01001153"
"1154","W01001154",26,1405,676,729,284,1121,0.141,0,0,10.928,4.94,16.009,"W01001154"
"1155","W01001155",22,1534,718,816,270,1264,0,0,0,0.589,3.732,4.321,"W01001155"
"1156","W01001156",5,1546,772,774,396,1150,0,0,0,0.119,4.137,4.256,"W01001156"
"1157","W01001157",12,1386,662,724,273,1113,0,0,0,0,3.895,3.895,"W01001157"
"1158","W01001158",65,1491,746,745,280,1211,0,0.894,0,2.234,5.854,8.982,"W01001158"
"1159","W01001159",32,1279,621,658,315,964,0,0.219,0,0.649,5.071,5.939,"W01001159"
"1160","W01001160",99,1594,797,797,295,1299,0.311,0,0.428,3.097,10.007,13.843,"W01001160"
"1161","W01001161",22,2224,1083,1141,538,1686,1.386,0,0,5.808,8.088,15.282,"W01001161"
"1162","W01001162",11,1718,844,874,417,1301,0,0.261,0,0.791,5.035,6.087,"W01001162"
"1163","W01001163",22,NA,NA,NA,NA,NA,NA,NA,NA,NA,NA,NA,NA
"1164","W01001164",42,1551,763,788,372,1179,1.033,0,0,2.86,3.736,7.629,"W01001164"
"1165","W01001165",34,1304,615,689,291,1013,0.848,0,0,0.857,3.55,5.255,"W01001165"
"1166","W01001166",16,1321,662,659,271,1050,0,0,0,2.336,3.843,6.179,"W01001166"
"1167","W01001167",26,1478,704,774,355,1123,0,0,0,2.105,5.031,7.136,"W01001167"
"1168","W01001168",10,1457,668,789,316,1141,0,0,0,0.524,4.493,5.017,"W01001168"
"1169","W01001169",91,1726,896,830,430,1296,1.318,0,0,2.688,8.342,12.348,"W01001169"
"1170","W01001170",11,1218,581,637,205,1013,0,0,0,0.426,4.003,4.429,"W01001170"
"1171","W01001171",38,1260,605,655,226,1034,0.462,0.31,0,1.521,4.835,7.128,"W01001171"
"1172","W01001172",25,1492,722,770,346,1146,0.437,0,0,1.401,3.357,5.195,"W01001172"
"1173","W01001173",61,1368,686,682,289,1079,1.08,0,0,0.989,2.848,4.917,"W01001173"
"1174","W01001174",24,1385,649,736,321,1064,0.373,0,0,0.524,2.853,3.75,"W01001174"
"1175","W01001175",41,1439,684,755,274,1165,0.383,0,0,1.149,2.858,4.39,"W01001175"
"1176","W01001176",21,1460,715,745,305,1155,0.787,0,0,0.992,3.192,4.971,"W01001176"
"1177","W01001177",24,1279,634,645,255,1024,0.47,0,0,2.102,4.327,6.899,"W01001177"
"1178","W01001178",13,1709,829,880,390,1319,0,2.185,0,1.804,2.784,6.773,"W01001178"
"1179","W01001179",60,1727,830,897,386,1341,1.762,0.527,0,2.156,4.878,9.323,"W01001179"
"1180","W01001180",45,1463,699,764,370,1093,0,0.782,0,1.328,2.83,4.94,"W01001180"
"1181","W01001181",19,1396,690,706,280,1116,0,1.665,0,0.322,4.197,6.184,"W01001181"
"1182","W01001182",76,1479,734,745,366,1113,0.275,0,0,1.476,6.441,8.192,"W01001182"
"1183","W01001183",19,1011,525,486,159,852,0.199,0,0,0.009,1.383,1.591,"W01001183"
"1184","W01001184",222,1963,961,1002,339,1624,6.321,0,0,5.399,10.374,22.094,"W01001184"
"1185","W01001185",34,1625,798,827,317,1308,0.357,0,0,0.429,6.05,6.836,"W01001185"
"1186","W01001186",22,1753,859,894,436,1317,0.046,0,0,0.242,4.833,5.121,"W01001186"
"1187","W01001187",35,1393,719,674,282,1111,0.893,0,0,0.546,4.856,6.295,"W01001187"
"1188","W01001188",33,1038,498,540,187,851,0.088,0,0,1.438,4.908,6.434,"W01001188"
"1189","W01001189",13,1663,804,859,431,1232,0.291,0,0,0.444,4.005,4.74,"W01001189"
"1190","W01001190",70,2531,1250,1281,597,1934,3.185,0,0,9.564,9.941,22.69,"W01001190"
"1191","W01001191",75,2494,1234,1260,579,1915,0.105,0,0,4.263,15.165,19.533,"W01001191"
"1192","W01001192",9,1491,726,765,360,1131,0,0,0,0.247,3.19,3.437,"W01001192"
"1193","W01001193",13,1213,593,620,230,983,0.146,0.095,0,0.133,3.175,3.549,"W01001193"
"1194","W01001194",64,2165,1067,1098,496,1669,2.829,0,0,1.876,8.271,12.976,"W01001194"
"1195","W01001195",101,1498,741,757,293,1205,0.987,0.714,0,6.241,11.572,19.514,"W01001195"
"1196","W01001196",12,1575,787,788,343,1232,0,0.532,0,0.536,4.645,5.713,"W01001196"
"1197","W01001197",10,1258,629,629,261,997,0.288,0,0,3.646,7.623,11.557,"W01001197"
"1198","W01001198",3,1556,761,795,316,1240,0,0,0,0.152,4.237,4.389,"W01001198"
"1199","W01001199",41,1710,820,890,372,1338,0.122,0.873,0,2.832,5.973,9.8,"W01001199"
"1200","W01001200",35,1009,479,530,208,801,0,0,0,1.396,2.863,4.259,"W01001200"
"1201","W01001201",65,1238,613,625,268,970,1.096,0.204,0,1.745,2.625,5.67,"W01001201"
"1202","W01001202",39,1780,899,881,370,1410,1.931,0,0,10.099,5.022,17.052,"W01001202"
"1203","W01001203",26,1380,660,720,323,1057,1.586,0,0,1.398,3.807,6.791,"W01001203"
"1204","W01001204",71,1321,624,697,297,1024,2.906,0.096,0,4.316,5.101,12.419,"W01001204"
"1205","W01001205",68,1588,773,815,311,1277,0.364,0.01,0,1.777,6.136,8.287,"W01001205"
"1206","W01001206",20,1482,691,791,304,1178,0,0.044,0,0.492,3.204,3.74,"W01001206"
"1207","W01001207",10,1387,672,715,318,1069,0,0.697,0,0.326,4.402,5.425,"W01001207"
"1208","W01001208",58,1596,750,846,327,1269,0,0.952,0,1.577,3.36,5.889,"W01001208"
"1209","W01001209",18,1403,696,707,400,1003,0,0.11,0,0.421,3.648,4.179,"W01001209"
"1210","W01001210",29,1449,700,749,298,1151,0,0.799,0,1.58,3.577,5.956,"W01001210"
"1211","W01001211",17,1595,768,827,361,1234,0,0.383,0,0.203,3.257,3.843,"W01001211"
"1212","W01001212",14,1342,645,697,311,1031,0,0.53,0,0.62,2.737,3.887,"W01001212"
"1213","W01001213",27,1361,634,727,288,1073,0,0.663,0,2.286,2.579,5.528,"W01001213"
"1214","W01001214",8,1299,634,665,264,1035,0,0.445,0,1.772,2.856,5.073,"W01001214"
"1215","W01001215",50,1037,514,523,200,837,0.978,0.05,0,1.095,2.9,5.023,"W01001215"
"1216","W01001216",28,1535,747,788,316,1219,0.343,0,0,2.467,3.153,5.963,"W01001216"
"1217","W01001217",13,1202,601,601,290,912,0.138,0,0,0.448,3.466,4.052,"W01001217"
"1218","W01001218",46,1541,761,780,343,1198,0,0.073,0,2.419,4.03,6.522,"W01001218"
"1219","W01001219",24,1332,662,670,253,1079,0.018,0.7,0,1.642,2.327,4.687,"W01001219"
"1220","W01001220",24,1479,725,754,337,1142,0.042,0.053,0,1.137,3.85,5.082,"W01001220"
"1221","W01001221",42,1467,672,795,368,1099,0.799,0,0,1.828,3.789,6.416,"W01001221"
"1222","W01001222",28,1596,751,845,428,1168,0.601,0,0,0.092,4.69,5.383,"W01001222"
"1223","W01001223",54,1593,780,813,297,1296,2.224,0,0,4.706,6.462,13.392,"W01001223"
"1224","W01001224",39,2129,1033,1096,613,1516,0.427,1.09,0,0.232,6.134,7.883,"W01001224"
"1225","W01001225",105,1574,767,807,308,1266,2.685,0.335,0.007,6.042,9.591,18.66,"W01001225"
"1226","W01001226",29,1719,800,919,426,1293,0.301,0.298,0,1.23,3.428,5.257,"W01001226"
"1227","W01001227",5,1334,656,678,273,1061,0,0,0,0.464,3.411,3.875,"W01001227"
"1228","W01001228",101,1502,751,751,253,1249,0.678,1.105,0,1.263,6.696,9.742,"W01001228"
"1229","W01001229",41,1433,749,684,282,1151,0,0.522,0,1.896,2.883,5.301,"W01001229"
"1230","W01001230",15,1603,788,815,332,1271,0,0.507,0,2.803,3.757,7.067,"W01001230"
"1231","W01001231",42,1540,746,794,311,1229,0,0.996,0,1.191,5.032,7.219,"W01001231"
"1232","W01001232",91,1394,690,704,261,1133,2.108,0.314,0,0.583,3.492,6.497,"W01001232"
"1233","W01001233",160,1700,845,855,310,1390,14.222,0,0,45.9,31.609,91.731,"W01001233"
"1234","W01001234",69,1456,706,750,258,1198,0.696,0,0,2.737,6.349,9.782,"W01001234"
"1235","W01001235",56,1685,792,893,358,1327,0.956,0,0,1.149,3.248,5.353,"W01001235"
"1236","W01001236",20,1516,715,801,330,1186,0.62,0,0,2.367,4.408,7.395,"W01001236"
"1237","W01001237",21,1467,682,785,329,1138,0,0,0,0.084,2.616,2.7,"W01001237"
"1238","W01001238",8,1673,774,899,507,1166,0,0,0,1.143,4.181,5.324,"W01001238"
"1239","W01001239",21,1365,673,692,291,1074,0,0,0,0.388,3.257,3.645,"W01001239"
"1240","W01001240",168,1945,949,996,328,1617,5.237,0,0,3.544,8.509,17.29,"W01001240"
"1241","W01001241",51,1727,841,886,360,1367,1.808,0,0,1.832,4.954,8.594,"W01001241"
"1242","W01001242",88,1357,675,682,244,1113,2.384,0,0,1.893,6.406,10.683,"W01001242"
"1243","W01001243",107,1377,652,725,254,1123,1.713,0.049,0,0.856,4.383,7.001,"W01001243"
"1244","W01001244",100,1364,642,722,193,1171,0.634,0.435,0,1.928,11.945,14.942,"W01001244"
"1245","W01001245",39,1303,640,663,221,1082,0.921,0.972,0,1.624,3.353,6.87,"W01001245"
"1246","W01001246",15,1381,664,717,224,1157,0,0.299,0,0,3.628,3.927,"W01001246"
"1247","W01001247",28,1696,830,866,358,1338,0,0,0,2.436,3.369,5.805,"W01001247"
"1248","W01001248",64,2054,1060,994,432,1622,0.695,0,0,4.566,5.992,11.253,"W01001248"
"1249","W01001249",34,1389,682,707,249,1140,0,0,0,1.977,3.147,5.124,"W01001249"
"1250","W01001250",65,1458,699,759,292,1166,0.903,0,0,6.585,11.089,18.577,"W01001250"
"1251","W01001251",12,1557,742,815,422,1135,0,0,0,0.66,3.547,4.207,"W01001251"
"1252","W01001252",16,1523,747,776,316,1207,0,0,0,0.653,4.023,4.676,"W01001252"
"1253","W01001253",48,1428,682,746,337,1091,0.132,1.203,0,4.318,4.279,9.932,"W01001253"
"1254","W01001254",76,NA,NA,NA,NA,NA,NA,NA,NA,NA,NA,NA,NA
"1255","W01001255",28,1598,771,827,370,1228,0.511,1.026,0,1.049,3.786,6.372,"W01001255"
"1256","W01001256",24,1222,596,626,259,963,0,0,0,1.096,2.373,3.469,"W01001256"
"1257","W01001257",25,1267,618,649,224,1043,0.416,0,0,1.644,4.965,7.025,"W01001257"
"1258","W01001258",99,1265,613,652,237,1028,4.715,0,0,3.163,3.776,11.654,"W01001258"
"1259","W01001259",14,1691,818,873,383,1308,0,0.945,0,2.704,3.513,7.162,"W01001259"
"1260","W01001260",28,1091,514,577,245,846,0.078,0.767,0,1.483,1.497,3.825,"W01001260"
"1261","W01001261",45,1258,632,626,227,1031,0.44,1.197,0,1.582,2.355,5.574,"W01001261"
"1262","W01001262",128,1356,724,632,204,1152,0.466,1.479,0,2.599,3.868,8.412,"W01001262"
"1263","W01001263",10,1711,932,779,160,1551,0,0,0,2.297,3.437,5.734,"W01001263"
"1264","W01001264",42,2083,1204,879,133,1950,0.448,1.057,0,3.766,2.786,8.057,"W01001264"
"1265","W01001265",40,1535,732,803,340,1195,0.659,0,0,2.429,2.816,5.904,"W01001265"
"1266","W01001266",36,1343,651,692,270,1073,0.499,0.28,0,6.763,3.325,10.867,"W01001266"
"1267","W01001267",29,1423,708,715,294,1129,2.706,0.007,0,6.516,5.706,14.935,"W01001267"
"1268","W01001268",23,1426,710,716,296,1130,0.188,0.778,0,2.102,2.729,5.797,"W01001268"
"1269","W01001269",55,1416,681,735,269,1147,1.023,0.02,0,2.43,3.772,7.245,"W01001269"
"1270","W01001270",16,1445,702,743,249,1196,0.253,0.202,0,3.459,3.542,7.456,"W01001270"
"1271","W01001271",44,1620,815,805,375,1245,0.974,0.346,0,5.352,4.765,11.437,"W01001271"
"1272","W01001272",16,1545,752,793,364,1181,0.574,0,0,2.859,3.408,6.841,"W01001272"
"1273","W01001273",40,1668,802,866,313,1355,0.736,0,0,2.49,2.021,5.247,"W01001273"
"1274","W01001274",27,1344,652,692,389,955,0.021,0.511,0,0.479,3.87,4.881,"W01001274"
"1275","W01001275",30,1807,891,916,420,1387,0.385,0.079,0,1.789,5.03,7.283,"W01001275"
"1276","W01001276",28,1395,684,711,274,1121,1.403,0,0,0.204,5.574,7.181,"W01001276"
"1277","W01001277",63,1211,591,620,257,954,0,0.676,0,0.24,2.85,3.766,"W01001277"
"1278","W01001278",15,1154,588,566,322,832,0,0.239,0,1.146,2.516,3.901,"W01001278"
"1279","W01001279",11,1182,548,634,280,902,0,0.1,0,0.467,2.095,2.662,"W01001279"
"1280","W01001280",25,1631,796,835,334,1297,0.091,0,0,2.126,5.1,7.317,"W01001280"
"1281","W01001281",21,1689,823,866,342,1347,0.179,0,0,1.948,5.333,7.46,"W01001281"
"1282","W01001282",14,2000,975,1025,452,1548,0,1.733,0,6.356,4.298,12.387,"W01001282"
"1283","W01001283",56,1503,715,788,304,1199,0,0.799,0,14.704,16.866,32.369,"W01001283"
"1284","W01001284",1,1161,592,569,306,855,0,0,0,0,2.949,2.949,"W01001284"
"1285","W01001285",52,1451,689,762,229,1222,1.241,0.979,0,1.98,2.715,6.915,"W01001285"
"1286","W01001286",59,1535,755,780,343,1192,0,0.837,0,2.075,2.19,5.102,"W01001286"
"1287","W01001287",55,1456,731,725,303,1153,0.2,0.582,0,3.617,2.916,7.315,"W01001287"
"1288","W01001288",47,1412,697,715,295,1117,0.604,0.356,0,1.488,2.879,5.327,"W01001288"
"1289","W01001289",31,1392,683,709,246,1146,0,2.01,0,10.601,9.487,22.098,"W01001289"
"1290","W01001290",25,1885,944,941,410,1475,0,2.56,0,2.84,5.968,11.368,"W01001290"
"1291","W01001291",57,1845,906,939,460,1385,1.059,0,0,2.033,6.794,9.886,"W01001291"
"1292","W01001292",7,1730,820,910,424,1306,0,0,0,0.238,7.386,7.624,"W01001292"
"1293","W01001293",29,1650,792,858,319,1331,0.124,0,0,0.421,7.61,8.155,"W01001293"
"1294","W01001294",4,1644,818,826,302,1342,0,0,0,0.821,6.86,7.681,"W01001294"
"1295","W01001295",69,1574,754,820,357,1217,0.293,0,0,0.286,7.386,7.965,"W01001295"
"1296","W01001296",46,1677,822,855,329,1348,0,0,0,4.474,6.706,11.18,"W01001296"
"1297","W01001297",95,1890,958,932,407,1483,0.568,0,0,2.151,4.652,7.371,"W01001297"
"1298","W01001298",61,1785,865,920,363,1422,0.003,0,0,1.38,9.766,11.149,"W01001298"
"1299","W01001299",53,1616,750,866,430,1186,0,0,0,0.534,4.257,4.791,"W01001299"
"1300","W01001300",51,1753,825,928,452,1301,0,0,0,0.132,5.301,5.433,"W01001300"
"1301","W01001301",29,1911,913,998,504,1407,0,0,0,0,4.564,4.564,"W01001301"
"1302","W01001302",26,1124,580,544,255,869,0.825,0.347,0,1.023,1.927,4.122,"W01001302"
"1303","W01001303",38,1200,583,617,286,914,0.747,0.057,0,0.98,4.178,5.962,"W01001303"
"1304","W01001304",17,1507,758,749,307,1200,0.001,1.005,0,3.068,2.832,6.906,"W01001304"
"1305","W01001305",40,1292,617,675,229,1063,0.159,0,0,0.57,3.011,3.74,"W01001305"
"1306","W01001306",103,1549,758,791,297,1252,1.959,0,0,1.757,4.79,8.506,"W01001306"
"1307","W01001307",67,1485,734,751,236,1249,0.331,0,0,0.618,4.301,5.25,"W01001307"
"1308","W01001308",26,1320,626,694,404,916,0,0,0,0,3.063,3.063,"W01001308"
"1309","W01001309",13,1277,604,673,329,948,0,0,0,0.395,2.738,3.133,"W01001309"
"1310","W01001310",7,1630,798,832,328,1302,0.054,0,0,1.292,4.036,5.382,"W01001310"
"1311","W01001311",20,1192,608,584,279,913,0,0,0,1.133,2.58,3.713,"W01001311"
"1312","W01001312",109,1557,738,819,297,1260,1.533,0.227,0,6.988,4.262,13.01,"W01001312"
"1313","W01001313",23,1560,752,808,311,1249,0.71,0.521,0,1.431,2.781,5.443,"W01001313"
"1314","W01001314",32,2179,1078,1101,507,1672,2.22,0,0,3.579,7.345,13.144,"W01001314"
"1315","W01001315",84,1709,895,814,292,1417,0.392,0,0,1.286,7.507,9.185,"W01001315"
"1316","W01001316",54,2862,1420,1442,620,2242,0.787,0,0,1.678,7.888,10.353,"W01001316"
"1317","W01001317",34,1599,772,827,293,1306,0.794,0,0,3.032,7.289,11.115,"W01001317"
"1318","W01001318",39,1501,769,732,278,1223,1.33,0,0,1.679,3.366,6.375,"W01001318"
"1319","W01001319",44,1646,820,826,328,1318,1.23,0,0,0.502,7.439,9.171,"W01001319"
"1320","W01001320",32,1546,769,777,338,1208,0.896,0.332,0,0.972,4.025,6.225,"W01001320"
"1321","W01001321",29,1572,750,822,392,1180,0.196,0.368,0,2.096,7.711,10.371,"W01001321"
"1322","W01001322",28,1592,780,812,316,1276,0.444,0.449,0,0.198,4.783,5.874,"W01001322"
"1323","W01001323",53,NA,NA,NA,NA,NA,NA,NA,NA,NA,NA,NA,NA
"1324","W01001324",93,2033,984,1049,351,1682,3.948,0,0,2.787,8.462,15.197,"W01001324"
"1325","W01001325",31,1540,770,770,361,1179,0,1.365,0,1.1,6.749,9.214,"W01001325"
"1326","W01001326",57,2102,1045,1057,475,1627,1.867,0.1,0,3.291,7.015,12.273,"W01001326"
"1327","W01001327",48,2169,1087,1082,426,1743,0.664,0.965,0,18.106,15.004,34.739,"W01001327"
"1328","W01001328",26,1606,812,794,403,1203,0.045,0.494,0,2.591,6.264,9.394,"W01001328"
"1329","W01001329",15,1577,761,816,369,1208,0.559,0.802,0,1.673,4.575,7.609,"W01001329"
"1330","W01001330",16,1473,741,732,322,1151,0,0.891,0,1.791,4.508,7.19,"W01001330"
"1331","W01001331",17,1785,884,901,471,1314,0,0.361,0,2.579,3.859,6.799,"W01001331"
"1332","W01001332",27,1926,982,944,489,1437,0,0.771,0,5.466,7.586,13.823,"W01001332"
"1333","W01001333",12,1615,770,845,450,1165,0,0.375,0,1.458,3.021,4.854,"W01001333"
"1334","W01001334",20,1495,732,763,397,1098,0.937,1.057,0,0.511,4.12,6.625,"W01001334"
"1335","W01001335",32,1274,638,636,255,1019,3.85,0.633,0,11.857,13.151,29.491,"W01001335"
"1336","W01001336",12,1437,735,702,257,1180,0.11,0,0,0.43,2.862,3.402,"W01001336"
"1337","W01001337",22,1558,774,784,341,1217,0,0,0,1.855,2.839,4.694,"W01001337"
"1338","W01001338",33,1744,887,857,381,1363,0.098,0,0,2.289,3.522,5.909,"W01001338"
"1339","W01001339",12,1457,668,789,360,1097,0,0,0,1.013,4.998,6.011,"W01001339"
"1340","W01001340",35,1809,915,894,390,1419,0.135,0,0,3.6,11.735,15.47,"W01001340"
"1341","W01001341",13,1807,850,957,377,1430,0.245,0,0,0.48,5.43,6.155,"W01001341"
"1342","W01001342",10,1168,567,601,253,915,0.814,0,0,0.21,3.815,4.839,"W01001342"
"1343","W01001343",5,1194,591,603,258,936,1.354,0,0,3.446,6.497,11.297,"W01001343"
"1344","W01001344",44,1708,836,872,326,1382,1.158,0,0,2.61,7.437,11.205,"W01001344"
"1345","W01001345",9,1537,738,799,517,1020,0.278,0,0,0.431,2.61,3.319,"W01001345"
"1346","W01001346",21,1535,742,793,344,1191,0.576,0,0,1.488,4.272,6.336,"W01001346"
"1347","W01001347",24,1442,699,743,285,1157,0.14,0.005,0,0.825,4.18,5.15,"W01001347"
"1348","W01001348",15,1812,834,978,489,1323,0,0,0,0.349,3.305,3.654,"W01001348"
"1349","W01001349",3,1971,985,986,542,1429,0,0.404,0,0.292,4.343,5.039,"W01001349"
"1350","W01001350",74,1767,877,890,356,1411,0,1.482,0,2.467,4.395,8.344,"W01001350"
"1351","W01001351",18,1504,754,750,235,1269,0.815,0.142,0,1.487,6.45,8.894,"W01001351"
"1352","W01001352",6,1845,890,955,428,1417,0,0,0,0.277,4.298,4.575,"W01001352"
"1353","W01001353",15,1595,787,808,296,1299,0,0,0,0.191,4.312,4.503,"W01001353"
"1354","W01001354",27,1646,816,830,335,1311,0,0.842,0,2.319,4.497,7.658,"W01001354"
"1355","W01001355",41,1619,814,805,276,1343,0.044,0.906,0,3.833,5.081,9.864,"W01001355"
"1356","W01001356",9,1259,627,632,281,978,0,0,0,0,3.182,3.182,"W01001356"
"1357","W01001357",32,1600,805,795,320,1280,0,0.923,0,2.75,13.102,16.775,"W01001357"
"1358","W01001358",25,1540,756,784,349,1191,0,0,0,1.184,6.741,7.925,"W01001358"
"1359","W01001359",95,1548,772,776,301,1247,2.099,1.342,0,1.843,8.637,13.921,"W01001359"
"1360","W01001360",40,1357,666,691,312,1045,0,0,0,7.786,20.633,28.419,"W01001360"
"1361","W01001361",32,1250,611,639,297,953,0,0,0,1.186,8.91,10.096,"W01001361"
"1362","W01001362",41,2062,1002,1060,381,1681,0,0,0,3.175,6.821,9.996,"W01001362"
"1363","W01001363",15,1493,731,762,359,1134,0.187,0,0,0.997,4.775,5.959,"W01001363"
"1364","W01001364",8,1930,945,985,543,1387,0,0,0,0.144,4.083,4.227,"W01001364"
"1365","W01001365",37,2125,1031,1094,523,1602,0.442,0,0,1.984,8.153,10.579,"W01001365"
"1366","W01001366",7,1692,836,856,343,1349,0,0,0,1.91,6.171,8.081,"W01001366"
"1367","W01001367",16,1516,767,749,341,1175,0,0,0,2.506,3.662,6.168,"W01001367"
"1368","W01001368",45,1553,757,796,377,1176,0.728,0,0,1.159,3.84,5.727,"W01001368"
"1369","W01001369",175,2242,1111,1131,432,1810,4.045,0.279,0,5.286,15.663,25.273,"W01001369"
"1370","W01001370",45,1686,818,868,293,1393,0,1.569,0,2.151,3.97,7.69,"W01001370"
"1371","W01001371",56,1450,685,765,334,1116,0.582,0,0,0.836,5.542,6.96,"W01001371"
"1372","W01001372",22,1943,910,1033,448,1495,1.071,0.588,0,0.254,4.236,6.149,"W01001372"
"1373","W01001373",55,1692,839,853,355,1337,0,1.111,0,1.591,3.328,6.03,"W01001373"
"1374","W01001374",11,1462,722,740,332,1130,0,0,0,2.209,5.381,7.59,"W01001374"
"1375","W01001375",29,1475,710,765,276,1199,0,1.536,0,2.376,4.048,7.96,"W01001375"
"1376","W01001376",23,1530,736,794,366,1164,0,2.01,0,1.918,3.873,7.801,"W01001376"
"1377","W01001377",39,1543,741,802,277,1266,2.424,0.692,0,5.937,5.158,14.211,"W01001377"
"1378","W01001378",46,1592,744,848,322,1270,0.004,0.468,0,1.249,5.282,7.003,"W01001378"
"1379","W01001379",14,1512,778,734,346,1166,0,0.209,0,0.958,3.795,4.962,"W01001379"
"1380","W01001380",13,1815,902,913,381,1434,0,0,0,2.923,7.318,10.241,"W01001380"
"1381","W01001381",9,1535,759,776,388,1147,0.278,0,0,2.563,7.282,10.123,"W01001381"
"1382","W01001382",9,1653,808,845,296,1357,0,0,0,1.422,6.333,7.755,"W01001382"
"1383","W01001383",60,1506,732,774,320,1186,1.242,0,0,0.93,5.367,7.539,"W01001383"
"1384","W01001384",12,1647,826,821,356,1291,0.653,0,0,1.561,3.626,5.84,"W01001384"
"1385","W01001385",44,1576,766,810,326,1250,3.711,0,0,6.416,11.937,22.064,"W01001385"
"1386","W01001386",6,1743,877,866,463,1280,0.415,0,0,1.298,4.359,6.072,"W01001386"
"1387","W01001387",66,1285,636,649,288,997,1.341,1.158,0,0.968,3.538,7.005,"W01001387"
"1388","W01001388",79,1855,872,983,502,1353,0.95,1.171,0,1.967,4.381,8.469,"W01001388"
"1389","W01001389",7,1162,581,581,261,901,0.174,0.551,0,0.373,3.234,4.332,"W01001389"
"1390","W01001390",13,1843,917,926,465,1378,0,0.08,0,2.015,7.472,9.567,"W01001390"
"1391","W01001391",17,1639,796,843,353,1286,0,0.486,0,2.745,5.113,8.344,"W01001391"
"1392","W01001392",23,1769,861,908,336,1433,1.222,0,0,4.279,7.486,12.987,"W01001392"
"1393","W01001393",17,1345,672,673,304,1041,0,0,0,0.072,4.252,4.324,"W01001393"
"1394","W01001394",6,1377,705,672,332,1045,0,0,0,0,4.056,4.056,"W01001394"
"1395","W01001395",44,1455,692,763,288,1167,0,1.148,0,0.844,3.772,5.764,"W01001395"
"1396","W01001396",2,1666,796,870,483,1183,0,0.433,0,0.847,3.3,4.58,"W01001396"
"1397","W01001397",6,1732,860,872,414,1318,0,0,0,0.347,4.446,4.793,"W01001397"
"1398","W01001398",48,2507,1265,1242,691,1816,0.365,0.516,0,0.184,6.328,7.393,"W01001398"
"1399","W01001399",22,1316,652,664,262,1054,0.022,0.522,0,0.153,2.364,3.061,"W01001399"
"1400","W01001400",8,1454,685,769,423,1031,0,0,0,0,4.074,4.074,"W01001400"
"1401","W01001401",34,1943,957,986,364,1579,1.401,0.922,0,0.954,9.23,12.507,"W01001401"
"1402","W01001402",9,1699,835,864,445,1254,0,0,0,0.445,3.93,4.375,"W01001402"
"1403","W01001403",35,1621,803,818,352,1269,0,1.682,0,1.497,2.844,6.023,"W01001403"
"1404","W01001404",11,1412,715,697,223,1189,0.092,0,0,0.148,4.181,4.421,"W01001404"
"1405","W01001405",57,1877,920,957,478,1399,0.166,0.193,0,0.796,5.945,7.1,"W01001405"
"1406","W01001406",50,1924,957,967,355,1569,2.232,0.128,0,1.095,7.468,10.923,"W01001406"
"1407","W01001407",9,1416,702,714,264,1152,0,0.301,0,0.559,4.116,4.976,"W01001407"
"1408","W01001408",7,1515,724,791,430,1085,0,0,0,0.636,2.646,3.282,"W01001408"
"1409","W01001409",9,1677,800,877,319,1358,0,0,0,1.221,5.656,6.877,"W01001409"
"1410","W01001410",14,1856,941,915,362,1494,0,0,0,0.082,4.414,4.496,"W01001410"
"1411","W01001411",32,1709,815,894,285,1424,0,1.029,0,1.939,6.447,9.415,"W01001411"
"1412","W01001412",63,1693,838,855,274,1419,0,1.406,0,0.94,6.004,8.35,"W01001412"
"1413","W01001413",51,1827,868,959,389,1438,0.514,1.529,0,1.776,5.659,9.478,"W01001413"
"1414","W01001414",31,1600,779,821,400,1200,0,0.097,0,0.98,4.056,5.133,"W01001414"
"1415","W01001415",22,1807,889,918,444,1363,1.538,0.201,0,3.025,4.586,9.35,"W01001415"
"1416","W01001416",25,1462,711,751,238,1224,0,0.419,0,2.883,3.622,6.924,"W01001416"
"1417","W01001417",4,1490,746,744,340,1150,0,0,0,0.541,3.772,4.313,"W01001417"
"1418","W01001418",61,1458,705,753,307,1151,0,1.341,0,5.471,7.795,14.607,"W01001418"
"1419","W01001419",62,1556,800,756,320,1236,0,0,0,14.949,30.483,45.432,"W01001419"
"1420","W01001420",4,1305,629,676,269,1036,0,0,0,0.055,4.065,4.12,"W01001420"
"1421","W01001421",10,1543,729,814,436,1107,0,0,0,0.046,3.158,3.204,"W01001421"
"1422","W01001422",18,1572,766,806,366,1206,0,0,0,0.085,3.505,3.59,"W01001422"
"1423","W01001423",31,1417,690,727,207,1210,0,0.578,0,0.196,4.261,5.035,"W01001423"
"1424","W01001424",52,1497,693,804,277,1220,0,0.846,0,1.414,3.878,6.138,"W01001424"
"1425","W01001425",33,1620,792,828,312,1308,0,0.735,0,2.353,4.288,7.376,"W01001425"
"1426","W01001426",65,1381,698,683,269,1112,2.292,0.127,0,1.78,5.732,9.931,"W01001426"
"1427","W01001427",8,1835,903,932,516,1319,0.158,0,0,0,3.561,3.719,"W01001427"
"1428","W01001428",3,1297,628,669,342,955,0,0.239,0,0.518,3.392,4.149,"W01001428"
"1429","W01001429",92,1157,561,596,223,934,5.185,1.476,0,6.235,11.267,24.163,"W01001429"
"1430","W01001430",38,2367,1142,1225,533,1834,0.779,3.202,0,9.408,9.173,22.562,"W01001430"
"1431","W01001431",30,1581,775,806,325,1256,0,0.494,0,5.722,13.905,20.121,"W01001431"
"1432","W01001432",34,2210,1082,1128,508,1702,0.736,0,0,3.152,10.517,14.405,"W01001432"
"1433","W01001433",33,1413,665,748,282,1131,0.451,0,0,2.298,4.525,7.274,"W01001433"
"1434","W01001434",34,1420,702,718,333,1087,0.38,0,0,1.302,5.278,6.96,"W01001434"
"1435","W01001435",30,1442,725,717,295,1147,0.022,0,0,1.023,3.899,4.944,"W01001435"
"1436","W01001436",46,1413,708,705,267,1146,0.091,0,0,0.805,4.489,5.385,"W01001436"
"1437","W01001437",7,1561,765,796,321,1240,0,0,0,2.309,3.952,6.261,"W01001437"
"1438","W01001438",75,1425,675,750,243,1182,2.15,0,0,0.862,6.748,9.76,"W01001438"
"1439","W01001439",22,1685,843,842,313,1372,0,0,0,1.845,4.529,6.374,"W01001439"
"1440","W01001440",31,1380,668,712,290,1090,1.47,0,0,0.504,4.018,5.992,"W01001440"
"1441","W01001441",18,1248,611,637,271,977,0.237,0.352,0,0.437,2.681,3.707,"W01001441"
"1442","W01001442",57,1238,614,624,257,981,0.818,0.369,0,0.731,2.928,4.846,"W01001442"
"1443","W01001443",71,1369,714,655,227,1142,0.837,0,0,1.511,5.388,7.736,"W01001443"
"1444","W01001444",14,1933,939,994,452,1481,0,0,0,2.104,6.317,8.421,"W01001444"
"1445","W01001445",30,1506,742,764,331,1175,0,0,0,3.429,5.072,8.501,"W01001445"
"1446","W01001446",82,1273,603,670,229,1044,2.437,0.075,0,1.324,6.482,10.318,"W01001446"
"1447","W01001447",35,1570,767,803,415,1155,0.219,0,0,0.387,2.742,3.348,"W01001447"
"1448","W01001448",45,1238,648,590,208,1030,1.023,0.796,0,0.208,5.244,7.271,"W01001448"
"1449","W01001449",32,1449,723,726,252,1197,0.441,0.447,0,1.133,3.699,5.72,"W01001449"
"1450","W01001450",15,1310,644,666,258,1052,0,0,0,1.973,4.356,6.329,"W01001450"
"1451","W01001451",47,1429,712,717,309,1120,2.891,0,0,4.504,4.004,11.399,"W01001451"
"1452","W01001452",29,1556,798,758,332,1224,0.681,0.018,0,5.505,7.22,13.424,"W01001452"
"1453","W01001453",30,1563,773,790,377,1186,0,0,0,0.764,8.704,9.468,"W01001453"
"1454","W01001454",14,1404,671,733,275,1129,0,0,0,4.171,7.465,11.636,"W01001454"
"1455","W01001455",4,1736,843,893,339,1397,0,0,0,0.727,2.88,3.607,"W01001455"
"1456","W01001456",29,1321,627,694,285,1036,0.335,0.322,0,1.229,5.212,7.098,"W01001456"
"1457","W01001457",19,1709,784,925,392,1317,0.096,0,0,0.192,4.753,5.041,"W01001457"
"1458","W01001458",75,1531,760,771,322,1209,0.621,0.823,0,4.928,3.436,9.808,"W01001458"
"1459","W01001459",7,1111,529,582,302,809,0,0.008,0,0.927,3.326,4.261,"W01001459"
"1460","W01001460",88,1743,875,868,329,1414,4.388,2.187,0,5.969,13.263,25.807,"W01001460"
"1461","W01001461",28,1420,705,715,282,1138,0.304,0.666,0,2.242,3.246,6.458,"W01001461"
"1462","W01001462",14,1518,720,798,332,1186,0,0,0,2.457,7.185,9.642,"W01001462"
"1463","W01001463",4,1892,906,986,353,1539,0,0,0,1.515,5.329,6.844,"W01001463"
"1464","W01001464",13,1544,788,756,333,1211,0,2.491,0,2.277,5.221,9.989,"W01001464"
"1465","W01001465",48,1566,769,797,323,1243,0.11,1.082,0,3.71,11.179,16.081,"W01001465"
"1466","W01001466",16,1687,892,795,297,1390,0,0.634,0,1.686,5.33,7.65,"W01001466"
"1467","W01001467",68,1946,937,1009,476,1470,0.067,1.291,0,1.805,8.395,11.558,"W01001467"
"1468","W01001468",29,1378,677,701,270,1108,0,0,0,0.975,4.475,5.45,"W01001468"
"1469","W01001469",13,1311,668,643,334,977,0,0,0,1.616,5.172,6.788,"W01001469"
"1470","W01001470",27,1482,734,748,256,1226,0.059,0,0,3.406,11.451,14.916,"W01001470"
"1471","W01001471",66,1752,856,896,416,1336,0.287,0,0,0.388,5.161,5.836,"W01001471"
"1472","W01001472",35,1473,742,731,285,1188,1.523,0,0,1.545,5.794,8.862,"W01001472"
"1473","W01001473",10,1399,646,753,356,1043,0.202,0,0,0.51,3.563,4.275,"W01001473"
"1474","W01001474",56,1549,784,765,312,1237,1.287,0,0,7.734,15.023,24.044,"W01001474"
"1475","W01001475",65,1209,584,625,235,974,0.904,0,0,1.046,4.589,6.539,"W01001475"
"1476","W01001476",37,1039,504,535,205,834,1.367,0,0,1.337,1.994,4.698,"W01001476"
"1477","W01001477",5,1443,717,726,305,1138,0,0,0,1.756,4.322,6.078,"W01001477"
"1478","W01001478",90,1471,714,757,274,1197,3.375,0.355,0,5.89,5.324,14.944,"W01001478"
"1479","W01001479",9,1511,710,801,352,1159,0,0,0,0.438,3.8,4.238,"W01001479"
"1480","W01001480",13,1495,713,782,303,1192,0.028,0,0,0.103,5.88,6.011,"W01001480"
"1481","W01001481",91,1586,798,788,249,1337,0.072,1.051,0,0.259,8.354,9.736,"W01001481"
"1482","W01001482",33,1213,607,606,286,927,1.366,1.878,0,5.809,4.858,13.911,"W01001482"
"1483","W01001483",10,1378,643,735,367,1011,0,0.133,0,0.076,3.753,3.962,"W01001483"
"1484","W01001484",5,1740,845,895,388,1352,1.091,0,0,1.699,6.253,9.043,"W01001484"
"1485","W01001485",16,1211,568,643,279,932,0,1.081,0,2.037,4.399,7.517,"W01001485"
"1486","W01001486",16,1522,762,760,346,1176,0.685,0.772,0,0.621,4.837,6.915,"W01001486"
"1487","W01001487",23,1550,791,759,345,1205,0.253,0.529,0,2.156,4.696,7.634,"W01001487"
"1488","W01001488",3,1592,774,818,387,1205,0,0.193,0,0.067,4.194,4.454,"W01001488"
"1489","W01001489",34,1616,783,833,362,1254,0,3.923,0,4.91,12.382,21.215,"W01001489"
"1490","W01001490",3,1297,630,667,271,1026,0.136,0,0,0.776,2.551,3.463,"W01001490"
"1491","W01001491",40,1808,873,935,402,1406,0.759,0,0,0.904,5.699,7.362,"W01001491"
"1492","W01001492",13,2335,1142,1193,549,1786,0,0,0,0.354,5.61,5.964,"W01001492"
"1493","W01001493",2,1941,942,999,367,1574,0,0,0,0.067,4.322,4.389,"W01001493"
"1494","W01001494",2,1509,732,777,279,1230,0.27,0,0,0.388,3.63,4.288,"W01001494"
"1495","W01001495",22,1796,829,967,313,1483,0,0,0,1.641,6.196,7.837,"W01001495"
"1496","W01001496",12,1438,691,747,323,1115,0,0,0,4.65,7.7,12.35,"W01001496"
"1497","W01001497",11,1527,720,807,368,1159,0,0,0,0.339,3.783,4.122,"W01001497"
"1498","W01001498",9,1176,561,615,286,890,0,0,0,0.466,1.265,1.731,"W01001498"
"1499","W01001499",10,1203,604,599,262,941,0,0,0,0.434,3.137,3.571,"W01001499"
"1500","W01001500",4,1323,638,685,268,1055,0,0,0,0.121,4.375,4.496,"W01001500"
"1501","W01001501",17,1344,665,679,371,973,0,0,0,0,2.887,2.887,"W01001501"
"1502","W01001502",9,1329,645,684,326,1003,0,0,0,0.128,4.042,4.17,"W01001502"
"1503","W01001503",3,1395,665,730,434,961,0,0,0,0,1.259,1.259,"W01001503"
"1504","W01001504",38,2045,983,1062,474,1571,0.081,0,0,2.302,7.522,9.905,"W01001504"
"1505","W01001505",117,2080,1018,1062,436,1644,2.897,0,0,7.851,15.82,26.568,"W01001505"
"1506","W01001506",96,1401,715,686,237,1164,0,0,0,1.773,9.35,11.123,"W01001506"
"1507","W01001507",18,2013,945,1068,403,1610,0.696,0.287,0,1.478,5.822,8.283,"W01001507"
"1508","W01001508",30,1226,587,639,186,1040,0.099,0.612,0,1.779,4.84,7.33,"W01001508"
"1509","W01001509",32,1482,725,757,284,1198,0.262,1.79,0,5.347,5.185,12.584,"W01001509"
"1510","W01001510",52,1522,714,808,315,1207,0.403,0,0,3.945,11.749,16.097,"W01001510"
"1511","W01001511",17,1604,771,833,326,1278,0,0,0,0.301,4.786,5.087,"W01001511"
"1512","W01001512",3,1357,680,677,192,1165,0,0,0,0,3.08,3.08,"W01001512"
"1513","W01001513",33,1503,753,750,269,1234,2.696,0,0,8.827,6.08,17.603,"W01001513"
"1514","W01001514",8,1180,576,604,213,967,0,0,0,1.436,2.701,4.137,"W01001514"
"1515","W01001515",26,1512,732,780,346,1166,0,0,0,1.487,6.435,7.922,"W01001515"
"1516","W01001516",1,1434,706,728,281,1153,0,0,0,0.559,3.274,3.833,"W01001516"
"1517","W01001517",72,1984,997,987,469,1515,1.095,0,0,1.312,7.064,9.471,"W01001517"
"1518","W01001518",11,1107,559,548,197,910,0,0,0,0.074,4.52,4.594,"W01001518"
"1519","W01001519",27,1351,683,668,283,1068,0,0,0,0.583,2.771,3.354,"W01001519"
"1520","W01001520",37,1801,866,935,399,1402,0.839,0,0,0.884,6.356,8.079,"W01001520"
"1521","W01001521",43,1452,729,723,318,1134,0,0,0,0.278,3.9,4.178,"W01001521"
"1522","W01001522",9,1701,822,879,378,1323,0,0,0,0.081,3.524,3.605,"W01001522"
"1523","W01001523",28,1492,726,766,304,1188,0.051,0,0,3.892,6.795,10.738,"W01001523"
"1524","W01001524",141,1836,934,902,336,1500,1.965,0,0,1.21,11.516,14.691,"W01001524"
"1525","W01001525",9,1541,763,778,374,1167,0,0,0,1.948,5.682,7.63,"W01001525"
"1526","W01001526",15,1341,634,707,325,1016,0,0,0,0.033,2.263,2.296,"W01001526"
"1527","W01001527",12,1206,581,625,178,1028,0.003,0,0,0.556,3.114,3.673,"W01001527"
"1528","W01001528",54,1118,540,578,244,874,0.794,0,0,2.5,8.973,12.267,"W01001528"
"1529","W01001529",39,2063,1034,1029,390,1673,1.573,0.531,0,1.768,4.846,8.718,"W01001529"
"1530","W01001530",9,1844,865,979,551,1293,0,0,0,0.237,4.159,4.396,"W01001530"
"1531","W01001531",15,1762,883,879,423,1339,0,0.901,0,2.049,5.759,8.709,"W01001531"
"1532","W01001532",25,1756,833,923,431,1325,0,0,0,0,3.76,3.76,"W01001532"
"1533","W01001533",28,1637,827,810,393,1244,0,0,0,9.288,14.549,23.837,"W01001533"
"1534","W01001534",5,1484,746,738,316,1168,0,0,0,1.279,4.26,5.539,"W01001534"
"1535","W01001535",9,1335,667,668,263,1072,0,0,0,0.228,3.604,3.832,"W01001535"
"1536","W01001536",12,1229,578,651,373,856,0,0,0,0.171,3.512,3.683,"W01001536"
"1537","W01001537",8,1200,604,596,200,1000,0,0,0,2.046,5.013,7.059,"W01001537"
"1538","W01001538",17,1327,624,703,332,995,0,0,0,0.172,2.926,3.098,"W01001538"
"1539","W01001539",7,1472,690,782,368,1104,0,0,0,0,3.318,3.318,"W01001539"
"1540","W01001540",14,1272,632,640,264,1008,0.353,0,0,1.546,2.664,4.563,"W01001540"
"1541","W01001541",20,1162,550,612,222,940,0.037,0,0,7.011,13.04,20.088,"W01001541"
"1542","W01001542",44,1791,905,886,342,1449,5.729,0,0,60.89,30.171,96.79,"W01001542"
"1543","W01001543",2,1440,710,730,332,1108,0,0,0,0.771,5.434,6.205,"W01001543"
"1544","W01001544",1,NA,NA,NA,NA,NA,NA,NA,NA,NA,NA,NA,NA
"1545","W01001545",10,1458,673,785,219,1239,0.885,0,0,3.99,10.885,15.76,"W01001545"
"1546","W01001546",11,1537,753,784,409,1128,0.366,0,0,0.479,3.413,4.258,"W01001546"
"1547","W01001547",10,NA,NA,NA,NA,NA,NA,NA,NA,NA,NA,NA,NA
"1548","W01001548",35,2121,1048,1073,432,1689,11.007,5.95,0,57.848,100.584,175.389,"W01001548"
"1549","W01001549",38,1480,755,725,291,1189,0,13.245,0,48.57,59.678,121.493,"W01001549"
"1550","W01001550",2,NA,NA,NA,NA,NA,NA,NA,NA,NA,NA,NA,NA
"1551","W01001552",8,1564,774,790,306,1258,3.11,0,0,1.626,9.117,13.853,"W01001552"
"1552","W01001553",26,2746,1342,1404,713,2033,0,2.155,0,4.462,8.366,14.983,"W01001553"
"1553","W01001554",150,1691,844,847,516,1175,5.478,0.65,0,1.308,6.143,13.579,"W01001554"
"1554","W01001555",49,1189,559,630,224,965,2.832,0,0,6.961,24.956,34.749,"W01001555"
"1555","W01001556",59,1204,580,624,266,938,2.448,0,0,2.367,3.827,8.642,"W01001556"
"1556","W01001557",42,1853,868,985,359,1494,0.731,0,0,2.067,5.807,8.605,"W01001557"
"1557","W01001558",4,1527,733,794,291,1236,0,0,0,0.06,4.765,4.825,"W01001558"
"1558","W01001559",5,1356,656,700,271,1085,0,0,0,0,4.41,4.41,"W01001559"
"1559","W01001560",75,1299,663,636,245,1054,4.851,3.668,0,34.19,43.061,85.77,"W01001560"
"1560","W01001561",41,1480,722,758,201,1279,2.708,0,0,2.022,10.91,15.64,"W01001561"
"1561","W01001562",69,1406,703,703,267,1139,1.272,0.689,0,5.33,27.123,34.414,"W01001562"
"1562","W01001563",5,1013,481,532,184,829,0.216,0,0,0.806,3.926,4.948,"W01001563"
"1563","W01001564",95,2319,1125,1194,510,1809,7.445,4.791,0,13.776,27.816,53.828,"W01001564"
"1564","W01001565",106,1861,944,917,379,1482,2.881,3.016,0,40.353,84.438,130.688,"W01001565"
"1565","W01001566",35,1268,659,609,220,1048,0,3.681,0,19.664,57.711,81.056,"W01001566"
"1566","W01001567",114,1016,481,535,157,859,4.373,10.005,0,21.049,32.081,67.508,"W01001567"
"1567","W01001568",39,1755,849,906,340,1415,0,34.504,0,44.358,94.629,173.491,"W01001568"
"1568","W01001569",34,1447,704,743,257,1190,0.334,3.248,0,5.029,13.867,22.478,"W01001569"
"1569","W01001570",3,NA,NA,NA,NA,NA,NA,NA,NA,NA,NA,NA,NA
"1570","W01001571",24,1255,634,621,220,1035,2.503,4.486,0,11.909,19.1,37.998,"W01001571"
"1571","W01001572",30,1583,772,811,382,1201,0.518,0.752,0.304,0.385,5.872,7.831,"W01001572"
"1572","W01001573",43,1503,763,740,334,1169,1.028,1.381,0.216,6.051,15.13,23.806,"W01001573"
"1573","W01001574",5,1487,749,738,325,1162,0,0,0,0.474,4.517,4.991,"W01001574"
"1574","W01001575",49,1253,656,597,250,1003,0,4.421,0,21.763,50.072,76.256,"W01001575"
"1575","W01001576",10,1088,529,559,237,851,0,0.157,0,0,1.922,2.079,"W01001576"
"1576","W01001577",24,1300,587,713,239,1061,0.4,1.38,0,1.525,4.234,7.539,"W01001577"
"1577","W01001578",49,2133,1089,1044,397,1736,0.687,3.006,0,5.025,14.217,22.935,"W01001578"
"1578","W01001579",24,1461,670,791,196,1265,0.556,0.533,0,0.666,4.575,6.33,"W01001579"
"1579","W01001580",41,1791,866,925,365,1426,0.035,0.635,0,0,3.751,4.421,"W01001580"
"1580","W01001581",89,1928,929,999,340,1588,6.41,0,0,15.604,56.189,78.203,"W01001581"
"1581","W01001582",70,1813,882,931,458,1355,0,1.571,0.274,5.277,6.559,13.681,"W01001582"
"1582","W01001583",84,1618,804,814,317,1301,9.309,2.023,0,22.85,23.552,57.734,"W01001583"
"1583","W01001584",8,1891,931,960,433,1458,0,0,0,0.246,4.942,5.188,"W01001584"
"1584","W01001585",2,1299,610,689,277,1022,0.238,0.411,0,0.491,2.92,4.06,"W01001585"
"1585","W01001586",61,2517,1213,1304,657,1860,2.165,0.116,0,0.184,8.116,10.581,"W01001586"
"1586","W01001587",49,1847,905,942,330,1517,0.546,0.668,0,0.329,6.317,7.86,"W01001587"
"1587","W01001588",17,1712,833,879,295,1417,0,0.902,0.089,3.462,5.662,10.115,"W01001588"
"1588","W01001589",16,1467,734,733,255,1212,0,0.04,0,0.301,4.886,5.227,"W01001589"
"1589","W01001590",81,2201,1120,1081,445,1756,3.019,7.158,0.13,35.01,55.007,100.324,"W01001590"
"1590","W01001591",12,1567,776,791,421,1146,0,0.335,0.001,0.114,7.752,8.202,"W01001591"
"1591","W01001592",6,1713,811,902,503,1210,0.113,0,0.003,0.18,4.69,4.986,"W01001592"
"1592","W01001593",36,1727,824,903,378,1349,0.475,0,0,0.529,5.855,6.859,"W01001593"
"1593","W01001594",18,1435,715,720,297,1138,0.166,5.433,0,9.731,39.614,54.944,"W01001594"
"1594","W01001595",13,1324,664,660,279,1045,1.456,1.026,0,8.317,38.33,49.129,"W01001595"
"1595","W01001596",2,1332,817,515,167,1165,0,0,0,0.136,4.336,4.472,"W01001596"
"1596","W01001597",13,1502,746,756,314,1188,0.683,1.141,0,2.142,4.094,8.06,"W01001597"
"1597","W01001598",20,1665,838,827,360,1305,0,0.724,0,0.35,3.513,4.587,"W01001598"
"1598","W01001599",39,2119,1024,1095,397,1722,4.869,0,0,8.303,13.76,26.932,"W01001599"
"1599","W01001600",64,1584,776,808,306,1278,0,0,0.013,0.586,3.681,4.28,"W01001600"
"1600","W01001601",10,1463,731,732,384,1079,0.067,0,0,0,3.122,3.189,"W01001601"
"1601","W01001602",11,1513,718,795,266,1247,0,0.133,0,0.241,3.824,4.198,"W01001602"
"1602","W01001603",22,1388,700,688,282,1106,0,0.299,0,0.153,3.223,3.675,"W01001603"
"1603","W01001604",108,1466,717,749,292,1174,0,1.388,2.018,3.6,5.472,12.478,"W01001604"
"1604","W01001605",21,1368,726,642,237,1131,0,0.526,0,1.927,1.585,4.038,"W01001605"
"1605","W01001606",31,1277,602,675,255,1022,0,0.423,0,0.672,1.674,2.769,"W01001606"
"1606","W01001607",21,1423,662,761,503,920,0,0.201,0,0.092,3.492,3.785,"W01001607"
"1607","W01001608",16,1544,768,776,348,1196,0,0.141,0,0.115,1.995,2.251,"W01001608"
"1608","W01001609",13,1467,659,808,477,990,0.084,0,0,0.052,3.046,3.182,"W01001609"
"1609","W01001610",7,1301,662,639,321,980,0,0,0,0,2.932,2.932,"W01001610"
"1610","W01001611",33,1319,628,691,351,968,0,0.311,0,0.569,2.155,3.035,"W01001611"
"1611","W01001612",49,1559,799,760,293,1266,0,0.408,0,0.371,2.42,3.199,"W01001612"
"1612","W01001613",16,1554,755,799,384,1170,0,0.238,0,0.374,2.269,2.881,"W01001613"
"1613","W01001614",14,1496,707,789,312,1184,0,0.44,0,0.129,4.031,4.6,"W01001614"
"1614","W01001615",54,1531,738,793,415,1116,0,0.001,0,0.568,3.725,4.294,"W01001615"
"1615","W01001616",16,1436,706,730,244,1192,0,0,0,0.196,3.738,3.934,"W01001616"
"1616","W01001617",3,1289,626,663,325,964,0,0,0,0.152,1.369,1.521,"W01001617"
"1617","W01001618",7,1123,549,574,233,890,0,0,0,0.359,2.87,3.229,"W01001618"
"1618","W01001619",6,1386,671,715,352,1034,0,0,0,0.295,2.029,2.324,"W01001619"
"1619","W01001620",14,1166,540,626,308,858,0,0,0,1.093,4.543,5.636,"W01001620"
"1620","W01001621",3,1368,645,723,308,1060,0,0,0,0.46,2.657,3.117,"W01001621"
"1621","W01001622",6,1274,613,661,274,1000,0,0,0,0.249,3.485,3.734,"W01001622"
"1622","W01001623",27,1491,703,788,271,1220,0,1.238,0,0.192,4.166,5.596,"W01001623"
"1623","W01001624",17,1275,597,678,319,956,0,0,0,0.653,4.578,5.231,"W01001624"
"1624","W01001625",45,1279,635,644,240,1039,0.15,1.869,0,11.749,10.213,23.981,"W01001625"
"1625","W01001626",12,1394,712,682,250,1144,0,0,0,0.108,4.094,4.202,"W01001626"
"1626","W01001627",22,1553,769,784,301,1252,0,0.676,0,2.487,4.752,7.915,"W01001627"
"1627","W01001628",9,1069,498,571,204,865,0,0.213,0,0.128,2.313,2.654,"W01001628"
"1628","W01001629",60,1395,664,731,210,1185,0,0.427,0,0.162,3.33,3.919,"W01001629"
"1629","W01001630",5,1462,714,748,239,1223,0,0,0,0.342,3.599,3.941,"W01001630"
"1630","W01001631",17,1423,678,745,284,1139,0,0,0,0,2.493,2.493,"W01001631"
"1631","W01001632",94,1377,659,718,338,1039,0.171,0.032,1.261,0.372,5.923,7.759,"W01001632"
"1632","W01001633",11,1535,735,800,483,1052,0.195,0,0,0.685,2.949,3.829,"W01001633"
"1633","W01001634",19,1529,706,823,405,1124,0,0.451,0,0.503,2.641,3.595,"W01001634"
"1634","W01001635",10,1348,650,698,300,1048,0.267,0,0,0.241,4.135,4.643,"W01001635"
"1635","W01001636",74,1897,944,953,545,1352,4.172,0,0,5.385,12.741,22.298,"W01001636"
"1636","W01001637",69,1724,837,887,445,1279,1.661,0,0,1.266,5.457,8.384,"W01001637"
"1637","W01001638",7,1190,584,606,263,927,0.366,0,0,0.144,2.406,2.916,"W01001638"
"1638","W01001639",76,1911,920,991,496,1415,1.971,0,0.376,1.038,7.527,10.912,"W01001639"
"1639","W01001640",30,1146,557,589,180,966,2.689,0,0,7.158,23.904,33.751,"W01001640"
"1640","W01001641",96,1368,682,686,245,1123,2.842,1.896,0,4.474,16.921,26.133,"W01001641"
"1641","W01001642",27,1691,810,881,403,1288,0,0,0,0.685,1.938,2.623,"W01001642"
"1642","W01001643",12,1486,716,770,497,989,0,0,0,0.255,2.468,2.723,"W01001643"
"1643","W01001644",32,2681,1348,1333,669,2012,0,0,0,0.214,5.241,5.455,"W01001644"
"1644","W01001645",2,1363,659,704,390,973,0,0,0,0.057,2.452,2.509,"W01001645"
"1645","W01001646",58,2120,1032,1088,430,1690,1.369,0,0,2.56,4.973,8.902,"W01001646"
"1646","W01001647",125,1483,717,766,245,1238,0.765,0,0,17.623,27.249,45.637,"W01001647"
"1647","W01001648",15,1529,730,799,348,1181,0.014,0,0,0.334,2.493,2.841,"W01001648"
"1648","W01001649",24,1472,747,725,286,1186,4.59,0,0,26.339,40.454,71.383,"W01001649"
"1649","W01001650",3,1489,724,765,349,1140,0,0,0,0.042,3.124,3.166,"W01001650"
"1650","W01001651",11,1525,746,779,279,1246,0.415,0,0,0.188,3.387,3.99,"W01001651"
"1651","W01001652",24,1773,825,948,460,1313,0.065,0,0,0.539,5.987,6.591,"W01001652"
"1652","W01001653",9,1449,703,746,292,1157,0,0,0,0.138,2.519,2.657,"W01001653"
"1653","W01001654",31,1629,790,839,355,1274,0.551,0,0,0.12,3.115,3.786,"W01001654"
"1654","W01001655",33,1621,786,835,314,1307,0.433,0,0,0.248,3.373,4.054,"W01001655"
"1655","W01001656",186,NA,NA,NA,NA,NA,NA,NA,NA,NA,NA,NA,NA
"1656","W01001657",99,1465,721,744,356,1109,2.25,0,2.283,8.49,11.587,24.61,"W01001657"
"1657","W01001658",20,1885,891,994,480,1405,0.002,0,0,1.282,9.268,10.552,"W01001658"
"1658","W01001659",18,1803,934,869,528,1275,0,0,0,0.093,2.229,2.322,"W01001659"
"1659","W01001660",60,1569,769,800,393,1176,1.894,0,0,13.98,8.47,24.344,"W01001660"
"1660","W01001661",78,2599,1329,1270,574,2025,1.077,0.056,0,0.779,6.092,8.004,"W01001661"
"1661","W01001662",52,1347,659,688,332,1015,0,0.835,0,0.125,2.821,3.781,"W01001662"
"1662","W01001663",83,1500,675,825,304,1196,0,1.28,0,0,3.106,4.386,"W01001663"
"1663","W01001664",111,1425,699,726,331,1094,0.996,0.421,0.641,0.535,2.826,5.419,"W01001664"
"1664","W01001665",32,1661,782,879,316,1345,0,0.462,0,0.067,5.01,5.539,"W01001665"
"1665","W01001666",15,1477,683,794,402,1075,0,0,0,0.122,2.573,2.695,"W01001666"
"1666","W01001667",10,1347,635,712,407,940,0.082,0,0,0.086,2.141,2.309,"W01001667"
"1667","W01001668",27,1140,576,564,287,853,0.656,0,0,0.672,3.192,4.52,"W01001668"
"1668","W01001669",15,1350,678,672,270,1080,0,0,0,0.203,4.45,4.653,"W01001669"
"1669","W01001670",36,2385,1202,1183,651,1734,0,0.634,0,3.537,7.279,11.45,"W01001670"
"1670","W01001671",36,1724,823,901,340,1384,0.121,0.664,0,1.125,6.406,8.316,"W01001671"
"1671","W01001672",34,1761,837,924,436,1325,0.013,0.954,0,2.234,6.245,9.446,"W01001672"
"1672","W01001673",21,1449,725,724,234,1215,0,0.74,0,0.369,2.868,3.977,"W01001673"
"1673","W01001674",14,1489,717,772,333,1156,0,0.398,0,0.093,3.671,4.162,"W01001674"
"1674","W01001675",27,1550,779,771,380,1170,0,0.192,0,0.263,2.182,2.637,"W01001675"
"1675","W01001676",28,1653,843,810,388,1265,0,0.305,0,1.066,3.477,4.848,"W01001676"
"1676","W01001677",55,1461,710,751,298,1163,0,0.966,0.539,0.16,2.111,3.776,"W01001677"
"1677","W01001678",15,1609,829,780,366,1243,0,0.504,0,0.19,3.046,3.74,"W01001678"
"1678","W01001679",27,1155,566,589,244,911,0,0,0.004,0.02,2.478,2.502,"W01001679"
"1679","W01001680",31,1247,616,631,285,962,0,0.334,0,0.325,1.465,2.124,"W01001680"
"1680","W01001681",66,1315,642,673,266,1049,0.651,0.257,0,0,3.448,4.356,"W01001681"
"1681","W01001682",64,1307,601,706,257,1050,0.591,0,0.011,0.559,3.821,4.982,"W01001682"
"1682","W01001683",68,1104,533,571,240,864,0.053,0,0.553,0.607,2.23,3.443,"W01001683"
"1683","W01001684",46,1409,696,713,282,1127,0.6,0,0.019,0.592,2.333,3.544,"W01001684"
"1684","W01001685",102,1652,862,790,304,1348,0.112,0.961,0,0.408,5.014,6.495,"W01001685"
"1685","W01001686",58,1392,671,721,283,1109,0,0.977,0,2.385,2.521,5.883,"W01001686"
"1686","W01001687",160,1729,945,784,286,1443,0.684,0.143,0,1.297,6.174,8.298,"W01001687"
"1687","W01001688",44,2648,1277,1371,727,1921,0.336,1.193,0,0.756,8.311,10.596,"W01001688"
"1688","W01001689",26,1773,801,972,522,1251,0.1,0.306,0,1.321,4.746,6.473,"W01001689"
"1689","W01001690",67,2216,1100,1116,557,1659,0,0.306,0,0.503,3.658,4.467,"W01001690"
"1690","W01001691",64,1479,737,742,320,1159,0,0.244,0,0.184,2.471,2.899,"W01001691"
"1691","W01001692",40,1988,1058,930,460,1528,0,0.02,0,0.065,3.384,3.469,"W01001692"
"1692","W01001693",113,1781,1012,769,413,1368,0,0.7,0,0.284,3.51,4.494,"W01001693"
"1693","W01001694",82,1961,1055,906,460,1501,0.122,0.112,0,0,3.111,3.345,"W01001694"
"1694","W01001695",164,3243,1868,1375,368,2875,0.947,0,0,0.429,3.404,4.78,"W01001695"
"1695","W01001696",33,1553,778,775,351,1202,0,0,0,0,2.37,2.37,"W01001696"
"1696","W01001697",48,1646,818,828,291,1355,0.396,0.064,0,0.003,1.382,1.845,"W01001697"
"1697","W01001698",62,1968,1073,895,353,1615,0.38,0.554,0,1.283,1.547,3.764,"W01001698"
"1698","W01001699",44,2198,1168,1030,569,1629,0.528,0,0,0.211,2.846,3.585,"W01001699"
"1699","W01001700",129,NA,NA,NA,NA,NA,NA,NA,NA,NA,NA,NA,NA
"1700","W01001701",174,NA,NA,NA,NA,NA,NA,NA,NA,NA,NA,NA,NA
"1701","W01001702",59,1850,879,971,494,1356,0.647,0,0,0.065,3.781,4.493,"W01001702"
"1702","W01001703",6,1266,622,644,339,927,0,0,0,0,2.167,2.167,"W01001703"
"1703","W01001704",38,1552,685,867,486,1066,0,0,0,0.502,2.118,2.62,"W01001704"
"1704","W01001705",24,1776,841,935,479,1297,0,0,0,0.532,4.405,4.937,"W01001705"
"1705","W01001706",43,1244,594,650,276,968,0.118,0,0,0.61,2.531,3.259,"W01001706"
"1706","W01001707",59,2068,990,1078,641,1427,0.533,0,0,0,2.634,3.167,"W01001707"
"1707","W01001708",30,1562,764,798,390,1172,0.219,0,0,0.153,3.074,3.446,"W01001708"
"1708","W01001709",68,1898,939,959,441,1457,0.395,0,0,1.107,3.519,5.021,"W01001709"
"1709","W01001710",37,1597,818,779,308,1289,0,0,0,0.847,2.333,3.18,"W01001710"
"1710","W01001711",123,1632,780,852,358,1274,0.827,2.692,0,1.11,5.127,9.756,"W01001711"
"1711","W01001712",46,1506,684,822,243,1263,0,0.264,0,0.174,2.219,2.657,"W01001712"
"1712","W01001713",58,1724,893,831,348,1376,0.254,0.095,0,0.581,2.047,2.977,"W01001713"
"1713","W01001714",32,1522,726,796,355,1167,0.368,0.009,0,1.215,3.21,4.802,"W01001714"
"1714","W01001715",31,1571,799,772,266,1305,0,0.6,0,0.405,1.88,2.885,"W01001715"
"1715","W01001716",51,1274,623,651,265,1009,0.355,0.06,0,0.85,1.855,3.12,"W01001716"
"1716","W01001717",4,1580,745,835,273,1307,0,0,0,0.628,1.751,2.379,"W01001717"
"1717","W01001718",12,1680,887,793,136,1544,0,0,0,0.574,2.157,2.731,"W01001718"
"1718","W01001719",34,2064,1001,1063,166,1898,0.148,0,0,1.914,2.265,4.327,"W01001719"
"1719","W01001720",25,1892,922,970,91,1801,0.409,0,0,0.284,1.414,2.107,"W01001720"
"1720","W01001721",153,2906,1336,1570,104,2802,0.654,0,0,2.279,1.646,4.579,"W01001721"
"1721","W01001722",23,1571,766,805,89,1482,0,0,0,0.315,1.714,2.029,"W01001722"
"1722","W01001723",627,NA,NA,NA,NA,NA,NA,NA,NA,NA,NA,NA,NA
"1723","W01001724",52,1984,909,1075,46,1938,0.048,0,0,0,1.414,1.462,"W01001724"
"1724","W01001725",8,2214,1141,1073,76,2138,0,0,0,0,1.073,1.073,"W01001725"
"1725","W01001726",83,1715,840,875,105,1610,0.157,0,0,0.634,2.434,3.225,"W01001726"
"1726","W01001727",74,1140,539,601,227,913,2.659,0,0,4.533,9.251,16.443,"W01001727"
"1727","W01001728",5,1478,739,739,332,1146,0.221,0,0,0,4.996,5.217,"W01001728"
"1728","W01001729",271,2203,1058,1145,533,1670,6.891,0,1.182,6.658,14.316,29.047,"W01001729"
"1729","W01001730",24,1489,707,782,262,1227,0,0,0,0.309,5.062,5.371,"W01001730"
"1730","W01001731",40,1446,699,747,350,1096,0,0,0,0.107,3.225,3.332,"W01001731"
"1731","W01001732",20,1591,774,817,355,1236,0,0,0,0.136,3.756,3.892,"W01001732"
"1732","W01001733",12,2077,1073,1004,275,1802,0,0,0,0,2.299,2.299,"W01001733"
"1733","W01001734",52,1526,736,790,347,1179,0,0,0,0.337,3.504,3.841,"W01001734"
"1734","W01001735",30,1624,749,875,344,1280,0,0,0,0.759,4.934,5.693,"W01001735"
"1735","W01001736",11,1395,656,739,276,1119,0,0,0,0.098,3.695,3.793,"W01001736"
"1736","W01001737",34,1585,741,844,480,1105,0.004,0,0,0,2.269,2.273,"W01001737"
"1737","W01001738",8,1421,665,756,502,919,0,0,0,0,1.835,1.835,"W01001738"
"1738","W01001739",22,1361,649,712,443,918,0,0,0,0,2.234,2.234,"W01001739"
"1739","W01001740",11,1521,715,806,399,1122,0,0,0,0,2.072,2.072,"W01001740"
"1740","W01001741",28,1619,714,905,603,1016,0,0,0,0,2.246,2.246,"W01001741"
"1741","W01001742",35,1515,675,840,487,1028,0.205,0,0,0.203,2.76,3.168,"W01001742"
"1742","W01001743",13,1424,694,730,263,1161,0,0,0,0.055,3.683,3.738,"W01001743"
"1743","W01001744",31,1592,753,839,429,1163,0.082,0,0,1.927,3.63,5.639,"W01001744"
"1744","W01001745",49,1355,656,699,311,1044,1.941,0,0,0.236,2.928,5.105,"W01001745"
"1745","W01001746",55,1542,708,834,379,1163,0.395,0,0,0.083,2.712,3.19,"W01001746"
"1746","W01001747",29,1624,771,853,273,1351,0.63,0,0,0.25,3.8,4.68,"W01001747"
"1747","W01001748",14,1569,750,819,408,1161,0,0,0,0,3.647,3.647,"W01001748"
"1748","W01001749",19,1488,727,761,284,1204,0,0,0,0,3.224,3.224,"W01001749"
"1749","W01001750",13,1650,776,874,314,1336,0,0,0,0.366,3.155,3.521,"W01001750"
"1750","W01001751",7,1661,811,850,402,1259,0,0,0,0,3.023,3.023,"W01001751"
"1751","W01001752",44,1625,804,821,320,1305,0,0,0,0.418,3.361,3.779,"W01001752"
"1752","W01001753",6,1653,756,897,493,1160,0,0,0,0,3.097,3.097,"W01001753"
"1753","W01001754",34,1711,811,900,303,1408,0.129,0,0,0.722,4.105,4.956,"W01001754"
"1754","W01001755",23,1432,734,698,180,1252,0.445,0,0,1.894,2.266,4.605,"W01001755"
"1755","W01001756",175,3809,1678,2131,340,3469,1.587,0,0,1.189,4.003,6.779,"W01001756"
"1756","W01001757",48,1493,730,763,273,1220,0.644,0,0,1.745,1.256,3.645,"W01001757"
"1757","W01001758",45,2056,916,1140,190,1866,0.242,0,0,1.315,2.17,3.727,"W01001758"
"1758","W01001759",98,1588,794,794,347,1241,0.453,0,0,0.806,7.368,8.627,"W01001759"
"1759","W01001760",22,1693,807,886,403,1290,0.373,0,0,0.622,2.435,3.43,"W01001760"
"1760","W01001761",19,1790,943,847,461,1329,0,0,0,1.008,2.494,3.502,"W01001761"
"1761","W01001762",34,1745,865,880,470,1275,0,0,0,0.19,2.31,2.5,"W01001762"
"1762","W01001763",84,NA,NA,NA,NA,NA,NA,NA,NA,NA,NA,NA,NA
"1763","W01001764",54,1993,1039,954,500,1493,0.074,0,0,0.853,2.108,3.035,"W01001764"
"1764","W01001765",21,1418,747,671,396,1022,0.259,0,0,0.93,1.679,2.868,"W01001765"
"1765","W01001766",30,1663,846,817,460,1203,0.182,0,0,0.067,1.539,1.788,"W01001766"
"1766","W01001767",83,1658,859,799,411,1247,0.368,0,0,0.308,2.205,2.881,"W01001767"
"1767","W01001768",57,1691,876,815,575,1116,0.336,0,0,1.523,1.062,2.921,"W01001768"
"1768","W01001769",37,1602,798,804,345,1257,0,0,0,0.205,3.747,3.952,"W01001769"
"1769","W01001770",61,1107,554,553,138,969,0,0,0,2.352,3.305,5.657,"W01001770"
"1770","W01001771",34,1645,819,826,354,1291,0,0,0,0.251,3.393,3.644,"W01001771"
"1771","W01001772",46,1413,667,746,262,1151,0.353,0,0,0.144,3.034,3.531,"W01001772"
"1772","W01001773",47,2524,1234,1290,642,1882,0.337,0,0,0.504,3.301,4.142,"W01001773"
"1773","W01001774",29,1399,693,706,318,1081,0.105,0,0,0,2.225,2.33,"W01001774"
"1774","W01001775",111,1592,779,813,310,1282,0.905,0,0,1.242,2.67,4.817,"W01001775"
"1775","W01001776",31,1347,648,699,296,1051,0.761,0,0,0.951,2.008,3.72,"W01001776"
"1776","W01001777",25,1496,738,758,304,1192,0,1.577,0,3.683,7.772,13.032,"W01001777"
"1777","W01001778",26,1873,930,943,419,1454,0.626,0,0,4.787,9.35,14.763,"W01001778"
"1778","W01001779",58,1445,703,742,245,1200,0.272,0,0,0.376,2.791,3.439,"W01001779"
"1779","W01001780",36,1750,790,960,265,1485,0.288,0,0,0.059,4.231,4.578,"W01001780"
"1780","W01001781",106,1736,849,887,333,1403,1.851,0.279,0,1.24,3.445,6.815,"W01001781"
"1781","W01001782",36,1437,706,731,288,1149,0.076,0.407,0,0.918,3.523,4.924,"W01001782"
"1782","W01001783",3,1268,603,665,295,973,0,0,0,0.025,2.517,2.542,"W01001783"
"1783","W01001784",13,1361,658,703,245,1116,0.092,0,0,0,3.207,3.299,"W01001784"
"1784","W01001785",11,1183,524,659,342,841,0,0,0,0.037,2.444,2.481,"W01001785"
"1785","W01001786",29,1555,755,800,376,1179,0.132,0,0,0.537,3.941,4.61,"W01001786"
"1786","W01001787",72,1461,728,733,339,1122,0.46,0,0,0,2.89,3.35,"W01001787"
"1787","W01001788",33,1431,726,705,361,1070,0.115,0,0,0.232,3.227,3.574,"W01001788"
"1788","W01001789",25,1527,729,798,304,1223,0.668,0,0,1.3,2.609,4.577,"W01001789"
"1789","W01001790",8,1187,539,648,287,900,0,0,0,0,1.755,1.755,"W01001790"
"1790","W01001791",51,1625,774,851,343,1282,0,0.339,0,0.678,5.16,6.177,"W01001791"
"1791","W01001792",17,1701,837,864,416,1285,0,0,0,0.142,4.545,4.687,"W01001792"
"1792","W01001793",9,1427,694,733,379,1048,0,0,0,0,2.656,2.656,"W01001793"
"1793","W01001794",2,1420,653,767,319,1101,0,0,0,0,3.446,3.446,"W01001794"
"1794","W01001795",16,1547,746,801,373,1174,0.072,0,0,0.105,3.461,3.638,"W01001795"
"1795","W01001796",4,1491,708,783,297,1194,0,0,0,0,3.006,3.006,"W01001796"
"1796","W01001797",26,1439,705,734,277,1162,0,0.001,0,0.047,2.586,2.634,"W01001797"
"1797","W01001798",3,1481,697,784,318,1163,0.32,0,0,0.008,2.599,2.927,"W01001798"
"1798","W01001799",15,1279,604,675,233,1046,0,0.62,0,0.208,2.504,3.332,"W01001799"
"1799","W01001800",9,1565,735,830,384,1181,0,0,0,0.181,2.548,2.729,"W01001800"
"1800","W01001801",44,NA,NA,NA,NA,NA,NA,NA,NA,NA,NA,NA,NA
"1801","W01001802",29,1588,746,842,291,1297,0,0,0,0.058,3.856,3.914,"W01001802"
"1802","W01001803",28,1573,734,839,334,1239,0,0.222,0,0,3.77,3.992,"W01001803"
"1803","W01001804",18,1566,786,780,385,1181,0,0,0,0,3.328,3.328,"W01001804"
"1804","W01001805",18,1490,726,764,372,1118,0,0,0,0,3.665,3.665,"W01001805"
"1805","W01001806",45,1642,808,834,268,1374,0,0.041,0,0.229,4.166,4.436,"W01001806"
"1806","W01001807",8,1567,708,859,507,1060,0,0,0,0,2.74,2.74,"W01001807"
"1807","W01001808",22,1634,739,895,526,1108,0,0,0,0,2.09,2.09,"W01001808"
"1808","W01001809",5,1309,641,668,291,1018,0,0,0,0,2.584,2.584,"W01001809"
"1809","W01001810",37,1678,807,871,528,1150,0,0,0,0.149,2.116,2.265,"W01001810"
"1810","W01001811",193,1503,706,797,545,958,2.501,0,0,0.275,5.982,8.758,"W01001811"
"1811","W01001812",12,1292,608,684,354,938,0,0,0,0,1.505,1.505,"W01001812"
"1812","W01001813",19,1519,741,778,379,1140,0,0,0,0.03,2.832,2.862,"W01001813"
"1813","W01001814",24,1421,683,738,277,1144,0,0,0,0,2.766,2.766,"W01001814"
"1814","W01001815",21,1353,643,710,321,1032,0,0,0,0,3.005,3.005,"W01001815"
"1815","W01001816",20,2625,1227,1398,709,1916,0,0,0,0.165,5.729,5.894,"W01001816"
"1816","W01001817",5,1406,665,741,335,1071,0,0,0,0,2.443,2.443,"W01001817"
"1817","W01001818",9,1528,740,788,392,1136,0,0,0,0.001,3.203,3.204,"W01001818"
"1818","W01001819",29,2287,1095,1192,489,1798,0,0,0,3.508,15.063,18.571,"W01001819"
"1819","W01001820",7,1196,598,598,289,907,0,0.604,0,0.687,5.595,6.886,"W01001820"
"1820","W01001821",34,1837,818,1019,232,1605,0,0,0,0.557,2.485,3.042,"W01001821"
"1821","W01001822",120,1647,757,890,283,1364,1.06,0,0,1.001,3.674,5.735,"W01001822"
"1822","W01001823",14,1334,648,686,302,1032,0,0,0,1.713,2.835,4.548,"W01001823"
"1823","W01001824",22,1566,796,770,249,1317,0.18,0,0,0.775,2.008,2.963,"W01001824"
"1824","W01001825",184,1775,883,892,346,1429,0.882,0,0,1.611,4.368,6.861,"W01001825"
"1825","W01001826",28,1353,635,718,236,1117,0,0,0,0.235,4.244,4.479,"W01001826"
"1826","W01001827",26,1610,745,865,374,1236,0,0,0,0.178,3.22,3.398,"W01001827"
"1827","W01001828",101,1535,747,788,261,1274,1.112,0,0,0.532,3.4,5.044,"W01001828"
"1828","W01001829",81,1807,1006,801,198,1609,0.066,0.307,0,0.14,1.693,2.206,"W01001829"
"1829","W01001830",42,1638,918,720,149,1489,0.196,0,0,0.445,1.216,1.857,"W01001830"
"1830","W01001831",53,1565,782,783,181,1384,0.234,0,0,0.14,1.174,1.548,"W01001831"
"1831","W01001832",51,1787,1072,715,67,1720,0,0,0,0,1.193,1.193,"W01001832"
"1832","W01001833",90,1626,857,769,280,1346,0.387,0,0,0.943,1.379,2.709,"W01001833"
"1833","W01001834",14,1607,817,790,188,1419,0,0.182,0,0.152,1.328,1.662,"W01001834"
"1834","W01001835",129,1622,901,721,102,1520,0.335,0.188,0,1.219,2.748,4.49,"W01001835"
"1835","W01001836",92,1599,843,756,308,1291,0,0,0,1.371,2.652,4.023,"W01001836"
"1836","W01001837",38,1524,827,697,133,1391,0,0,0,0.458,1.279,1.737,"W01001837"
"1837","W01001838",14,1782,908,874,253,1529,0,0,0,0.344,1.485,1.829,"W01001838"
"1838","W01001839",33,1609,787,822,185,1424,0.001,0,0,0,1.351,1.352,"W01001839"
"1839","W01001840",38,1752,870,882,327,1425,0,0.968,0,0.351,3.913,5.232,"W01001840"
"1840","W01001841",17,2025,969,1056,540,1485,0,0.717,0,0.644,4.094,5.455,"W01001841"
"1841","W01001842",139,1748,853,895,431,1317,0.263,0,0.626,1.249,8.997,11.135,"W01001842"
"1842","W01001843",169,2167,1070,1097,567,1600,2.289,0.958,0.543,2.186,6.162,12.138,"W01001843"
"1843","W01001844",5,2028,946,1082,521,1507,0,0,0,0,4.465,4.465,"W01001844"
"1844","W01001845",26,NA,NA,NA,NA,NA,NA,NA,NA,NA,NA,NA,NA
"1845","W01001846",18,1727,851,876,500,1227,0,0.336,0,0.224,4.032,4.592,"W01001846"
"1846","W01001847",22,1535,759,776,251,1284,0,0.112,0,0.171,5.273,5.556,"W01001847"
"1847","W01001848",35,1447,704,743,298,1149,0.283,0,0,1.026,2.648,3.957,"W01001848"
"1848","W01001849",20,1558,737,821,301,1257,0.189,0,0,0.354,4.232,4.775,"W01001849"
"1849","W01001850",33,1931,930,1001,396,1535,0.034,0,0,0.269,4.816,5.119,"W01001850"
"1850","W01001851",23,1482,727,755,276,1206,0,0,0,0,3.403,3.403,"W01001851"
"1851","W01001852",104,1817,848,969,388,1429,1.078,0,0,5.22,7.46,13.758,"W01001852"
"1852","W01001853",20,1562,734,828,238,1324,0.03,0,0,0.099,3.418,3.547,"W01001853"
"1853","W01001854",6,1572,711,861,216,1356,0,0,0,0,2.991,2.991,"W01001854"
"1854","W01001855",19,1799,923,876,481,1318,0,0,0,0,2.198,2.198,"W01001855"
"1855","W01001856",70,1852,1073,779,377,1475,0.048,0,0,1.1,2.219,3.367,"W01001856"
"1856","W01001857",83,1856,978,878,429,1427,0.499,0.331,0,0.132,1.743,2.705,"W01001857"
"1857","W01001858",74,1694,825,869,235,1459,0.82,0,0,3.708,1.907,6.435,"W01001858"
"1858","W01001859",23,1421,716,705,203,1218,0.228,0.093,0,0.38,1.507,2.208,"W01001859"
"1859","W01001860",14,1707,850,857,272,1435,0,0.197,0,0.013,1.003,1.213,"W01001860"
"1860","W01001861",77,1709,874,835,275,1434,0.294,0.092,0,1.675,2.447,4.508,"W01001861"
"1861","W01001862",87,1733,976,757,392,1341,0.595,0,0,0.766,1.929,3.29,"W01001862"
"1862","W01001863",47,1564,760,804,335,1229,0,0.723,0,0.961,3.017,4.701,"W01001863"
"1863","W01001864",51,1505,723,782,266,1239,0,1.165,0,0.292,2.277,3.734,"W01001864"
"1864","W01001865",60,1321,636,685,259,1062,0,0.498,0,1.076,3.433,5.007,"W01001865"
"1865","W01001866",51,1510,701,809,310,1200,0,0.551,0,0.54,2.378,3.469,"W01001866"
"1866","W01001867",23,1429,662,767,447,982,0,0,0,0,2.384,2.384,"W01001867"
"1867","W01001868",30,1498,680,818,384,1114,0,0.057,0,0.271,3.068,3.396,"W01001868"
"1868","W01001869",5,1395,666,729,238,1157,0,0,0,0,1.026,1.026,"W01001869"
"1869","W01001870",24,1377,685,692,307,1070,0,0,0,0.001,2.023,2.024,"W01001870"
"1870","W01001871",33,1594,741,853,456,1138,0,0,0,0.135,2.224,2.359,"W01001871"
"1871","W01001872",28,1525,769,756,325,1200,0,0,0,0.031,1.517,1.548,"W01001872"
"1872","W01001873",34,1699,840,859,370,1329,0,0,0,0.382,2.784,3.166,"W01001873"
"1873","W01001874",85,1429,697,732,359,1070,0,0,0,3.72,8.529,12.249,"W01001874"
"1874","W01001875",126,2695,1307,1388,753,1942,0.724,0,0,3.484,10.061,14.269,"W01001875"
"1875","W01001876",12,1547,756,791,427,1120,0,0,0,0.385,2.524,2.909,"W01001876"
"1876","W01001877",46,1710,839,871,359,1351,0.291,0,0,0.22,4.888,5.399,"W01001877"
"1877","W01001878",65,1574,710,864,378,1196,0.061,0,0,0.133,3.78,3.974,"W01001878"
"1878","W01001879",19,1904,876,1028,557,1347,0,0,0,0,3.602,3.602,"W01001879"
"1879","W01001880",9,1554,691,863,590,964,0,0,0,0,2.524,2.524,"W01001880"
"1880","W01001881",24,1438,668,770,337,1101,0,0.237,0,0.066,2.982,3.285,"W01001881"
"1881","W01001882",16,1824,893,931,490,1334,0,0,0,0.203,5.657,5.86,"W01001882"
"1882","W01001883",32,1600,754,846,418,1182,0,0,0,0,3.151,3.151,"W01001883"
"1883","W01001884",6,1374,592,782,538,836,0,0,0,0,2.215,2.215,"W01001884"
"1884","W01001885",46,2017,938,1079,631,1386,0,1.676,0,1.945,9.682,13.303,"W01001885"
"1885","W01001886",14,1199,572,627,323,876,0,0,0,0,2.517,2.517,"W01001886"
"1886","W01001887",29,1573,779,794,360,1213,0.818,0,0,0.845,2.978,4.641,"W01001887"
"1887","W01001888",6,1686,824,862,422,1264,0,0,0,0.315,4.751,5.066,"W01001888"
"1888","W01001889",35,1546,760,786,275,1271,0.404,0,0,1.001,3.802,5.207,"W01001889"
"1889","W01001890",118,1610,758,852,260,1350,0.57,0,0,0.646,2.879,4.095,"W01001890"
"1890","W01001891",55,1659,763,896,321,1338,0,0,0,1.236,4.05,5.286,"W01001891"
"1891","W01001892",3,1437,681,756,266,1171,0,0,0,0.143,3.731,3.874,"W01001892"
"1892","W01001893",283,1871,880,991,413,1458,5.381,0,2.768,2.304,8.548,19.001,"W01001893"
"1893","W01001894",29,1589,767,822,327,1262,0.703,0,0,0.339,3.471,4.513,"W01001894"
"1894","W01001895",39,1634,838,796,298,1336,0.951,0,0,3.667,3.627,8.245,"W01001895"
"1895","W01001896",10,1533,722,811,328,1205,0.393,0,0,0.52,2.877,3.79,"W01001896"
"1896","W01001897",66,1923,957,966,347,1576,28.115,10.375,0,69.938,102.772,211.2,"W01001897"
"1897","W01001898",26,1518,748,770,300,1218,2.522,0,0,6.677,10.736,19.935,"W01001898"
"1898","W01001899",11,2053,976,1077,386,1667,1.853,0.054,0,3.564,12.75,18.221,"W01001899"
"1899","W01001900",5,1539,770,769,352,1187,0.627,0.047,0,3.985,9.326,13.985,"W01001900"
"1900","W01001903",15,2063,990,1073,348,1715,3.109,0,0,2.049,7.771,12.929,"W01001903"
"1901","W01001904",26,1737,857,880,354,1383,4.516,3.615,0,25.093,50.228,83.452,"W01001904"
"1902","W01001905",19,2106,1047,1059,391,1715,12.929,9.52,0,34.008,89.496,145.953,"W01001905"
"1903","W01001906",6,1916,974,942,342,1574,0,48.075,0,128.101,63.61,239.786,"W01001906"
"1904","W01001907",6,1415,721,694,290,1125,0,22.968,0,50.361,109.052,182.381,"W01001907"
"1905","W01001908",3,2141,1041,1100,391,1750,0,0.011,0,0.176,4.428,4.615,"W01001908"
"1906","W01001909",3,2651,1281,1370,583,2068,0,0.112,0,0.276,6.043,6.431,"W01001909"
"1907","W01001910",10,1656,842,814,420,1236,0.042,0.823,0,1.971,3.115,5.951,"W01001910"
"1908","W01001912",4,1480,739,741,276,1204,0,7.969,0,8.157,8.492,24.618,"W01001912"
"1909","W01001913",57,1440,753,687,336,1104,4.489,0,2.879,15.588,11.174,34.13,"W01001913"
"1910","W01001914",3,1841,929,912,539,1302,0.629,0,0,2.956,6.527,10.112,"W01001914"
"1911","W01001915",1,1774,872,902,544,1230,0,0.541,0,0.525,3.856,4.922,"W01001915"
"1912","W01001916",6,1529,745,784,446,1083,0,0,0,0.361,3.886,4.247,"W01001916"
"1913","W01001917",12,1507,751,756,337,1170,0.737,0.612,0,1.624,3.615,6.588,"W01001917"
"1914","W01001919",1,1405,687,718,395,1010,0,0,0,0.474,3.471,3.945,"W01001919"
"1915","W01001920",5,1206,607,599,317,889,0.053,0.448,0,0.038,2.981,3.52,"W01001920"
"1916","W01001921",4,1577,764,813,499,1078,0.062,0.902,0,0.137,4.037,5.138,"W01001921"
"1917","W01001922",6,1976,1108,868,57,1919,0,0,0,1.186,1.686,2.872,"W01001922"
"1918","W01001923",10,1254,630,624,240,1014,0,1.395,0,2.26,5.206,8.861,"W01001923"
"1919","W01001924",3,1333,645,688,326,1007,0,0.106,0,1.327,4.091,5.524,"W01001924"
"1920","W01001925",24,2333,1146,1187,456,1877,3.261,4.837,0,11.438,12.437,31.973,"W01001925"
"1921","W01001926",60,2196,1059,1137,376,1820,6.418,1.79,0,8.669,25.963,42.84,"W01001926"
"1922","W01001927",3,1331,626,705,259,1072,1.202,0,0,0.945,4.513,6.66,"W01001927"
"1923","W01001928",2,1130,594,536,142,988,1.182,0,0,1.106,4.134,6.422,"W01001928"
"1924","W01001929",11,1303,707,596,195,1108,0.22,0,0,0.249,2.28,2.749,"W01001929"
"1925","W01001930",4,2179,1115,1064,432,1747,0,19.353,0,51.253,86.902,157.508,"W01001930"
"1926","W01001931",18,1368,723,645,220,1148,0.592,0.002,0,0.419,3.439,4.452,"W01001931"
"1927","W01001932",6,2931,1478,1453,627,2304,0,24.307,0,80.374,148.377,253.058,"W01001932"
"1928","W01001933",15,2243,1113,1130,288,1955,22.825,16.282,0,117.775,48.843,205.725,"W01001933"
"1929","W01001934",14,3980,2026,1954,235,3745,3.295,0.676,0,6.897,8.124,18.992,"W01001934"
"1930","W01001935",7,1095,551,544,189,906,1.633,0,0,1.304,3.717,6.654,"W01001935"
"1931","W01001936",8,2285,1139,1146,210,2075,2.094,0,0,4.629,4.471,11.194,"W01001936"
"1932","W01001937",14,2078,1009,1069,387,1691,0.771,10.018,0,19.438,23.575,53.802,"W01001937"
"1933","W01001938",14,1169,716,453,29,1140,0.628,0.043,0,0.176,2.247,3.094,"W01001938"
"1934","W01001939",93,1020,641,379,84,936,2.332,0,0,1.095,9.534,12.961,"W01001939"
"1935","W01001940",8,1111,643,468,63,1048,0.843,0,0,7.037,1.66,9.54,"W01001940"
"1936","W01001941",17,1099,679,420,81,1018,0.332,0,0,0.761,3.083,4.176,"W01001941"
"1937","W01001942",14,1355,711,644,245,1110,0.35,0,0,0.355,2.886,3.591,"W01001942"
"1938","W01001943",14,1098,608,490,112,986,1.559,0,0,4.211,3.796,9.566,"W01001943"
"1939","W01001944",2,1027,580,447,100,927,0.239,0,0,0.203,0.971,1.413,"W01001944"
"1940","W01001945",2,1303,760,543,62,1241,0,0,0,0.232,1.783,2.015,"W01001945"
"1941","W01001946",3,1339,702,637,250,1089,0,0,0,0.044,1.549,1.593,"W01001946"
"1942","W01001947",15,1504,751,753,156,1348,2.763,0,0,0.796,6.011,9.57,"W01001947"
"1943","W01001948",4,1618,782,836,424,1194,0.185,0.641,0,0.389,5.811,7.026,"W01001948"
"1944","W01001950",3,1082,605,477,88,994,0.055,0,0,0.63,0.39,1.075,"W01001950"
"1945","W01001951",10,1016,582,434,111,905,0.172,0,0,0.524,3.492,4.188,"W01001951"
"1946","W01001952",11,1238,644,594,132,1106,1.354,0,0,0.432,4.187,5.973,"W01001952"
"1947","W01001953",4,1499,731,768,343,1156,0.203,0.401,0,0.234,3.542,4.38,"W01001953"
"1948","W01001954",2,1537,750,787,312,1225,0,1.233,0,0.424,4.585,6.242,"W01001954"
"1949","W01001955",77,1555,942,613,59,1496,2.26,1.336,0,1.356,7.484,12.436,"W01001955"
"1950","W01001956",8,2921,1492,1429,314,2607,1.154,0,0,1.784,4.622,7.56,"W01001956"
"1951","W01001957",10,1036,669,367,112,924,0.599,0,0,0.027,2.439,3.065,"W01001957"
